cost	target-start	target-end	target-length	left-primer-start	left-primer-num-primers	left-primer-frac-bound	left-primer-target-sequences	right-primer-start	right-primer-num-primers	right-primer-frac-bound	right-primer-target-sequences	num-guides	total-frac-bound-by-guides	guide-target-sequences	guide-target-sequence-positions
2.7777	13774	13898	124	13774	1	1.0	TGGCCATTTTAATAAGGAGTTTTATGACTT	13868	1	1.0	CAAAAGGGTGATGCTGCAATTAAAGATTTT	1	1.0	CTCAAGGGTTTTTCGATGAAGGTTCAGA	{13812}
2.8905319690521503	12640	12791	151	12640	1	1.0	TGTCCGTGCATTTGACGTTTACAATAAAGA	12761	1	1.0	ATTAAGTCAGTTATGGACCACGAGCAGTCC	1	1.0	CTTGAAGTCCAATTGTGTGCGCTTCAAG	{12691}
2.9797666660097972	14857	15002	145	14857	1	1.0	TGGTTACATTGCTGATATTAGTGCTTTTAA	14972	1	1.0	TTTTGCTCACAGCACACTATGCAGATTGTA	2	1.0	AGCTAAATGTTGGACTGAGGAAGACCTT CAAAACAGTGTATTCATGAGTACTAGTA	{14926} {14903}
3.0612548428519353	13339	13554	215	13339	1	1.0	TTATGATTTGTTGAAATATGATTTCACAGA	13524	1	1.0	TATGCAGAAAAGTGTTTATTGATGGTGTAC	1	1.0	ACCACAATTCCAAATACAGCTTTTGGAC	{13493}
3.103397268051916	15367	15552	185	15367	1	1.0	AACAGTTCTAAGATGCGGTGATTGTTTACG	15522	1	1.0	TGTATCTTGGAGGTTTGAATTATTACTGTG	2	1.0	CAGACCGATGTTGTGCACTAAGTGCGCC TGCTTATGATCATGTGTTTGGCACTGAT	{15397} {15421}
3.103801953228442	12554	12791	237	12554	1	1.0	AAGTTTTGATAACAGTTATTTAAACGAGTC	12761	1	1.0	ATTAAGTCAGTTATGGACCACGAGCAGTCC	1	1.0	GCCCTGCAATGGTACAGACATAGATTAT	{12610}
3.1109657561098882	15799	16040	241	15799	1	1.0	GGAGATTGTAGGTCCTAAGGAACTTTTGCT	16010	1	1.0	TTTATTTTGACTTCTCATAATGTTGCTCCA	1	1.0	TGGTGAATTTGTGTTTGAGAAAGTAGAT	{15919}
3.1906433771173464	12443	12532	89	12443	1	1.0	AGTGCCTATAGGTACAAATGACCCTATAAG	12502	2	1.0	TCTGTGGTTGCTGGCTCAATCATGGTTGTA TTTGTGGTTGTTGGCTTAATCATGGCTGTA	1	1.0	TTTTGTCTTGAAAATACTGTTTGTAAAG	{12474}
3.2015110903442126	12233	12323	90	12233	2	1.0	TGATGCTGTTAAACAAGGCGCAAAACCTGT TGATGCTGTTAGACAAGGTGCAAAACCCGT	12293	1	1.0	TTCTGGTAGTGGTCAGGCTATTACTAGTAC	1	1.0	GCAACTGTGTAAAGATGTTGACTAATGG	{12265}
3.2221999999999995	13462	13554	92	13462	2	1.0	GCATTGCGCAAATTTTAACACACTATTTGC GCATTGTTCAAATTTTAACACACTCTTCGC	13524	1	1.0	TATGCAGAAAAGTGTTTATTGATGGTGTAC	1	1.0	ACCACAATTCCAAATACAGCTTTTGGAC	{13493}
