cost	target-start	target-end	target-length	left-primer-start	left-primer-num-primers	left-primer-frac-bound	left-primer-target-sequences	right-primer-start	right-primer-num-primers	right-primer-frac-bound	right-primer-target-sequences	num-guides	total-frac-bound-by-guides	guide-target-sequences	guide-target-sequence-positions
2.5126942636811997	30885	30973	88	30885	1	0.9909638554216867	AAAATTCCATGAGTGGAGCTTCTGCTGATT	30943	1	0.9939759036144579	CACACAAGGCAGATGGGCTATGTAAACGTT	1	0.9909638554216867	CAACTCAGGCATAAACACTCATGATGAC	{30915}
2.534811090344213	30665	30755	90	30665	1	0.9909638554216867	GGAGCCATTAAATTGGATGACAAAGATCCA	30725	1	0.9939759036144579	AAGCACATTGACGCATACAAAACATTCCCA	1	0.9909638554216867	CAATTCAAAGACAACGTCATACTGCTGA	{30695}
2.565364373321448	30623	30716	93	30623	1	0.9939759036144579	GGCATGGAAGTCACACCTTCGGGAACATGG	30686	1	0.9909638554216867	AAAGATCCACAATTCAAAGACAACGTCATA	1	0.9909638554216867	CTGACTTATCATGGAGCCATTAAATTGG	{30653}
2.7111377053709504	30898	31010	112	30898	1	0.9909638554216867	TGGAGCTTCTGCTGATTCAACTCAGGCATA	30980	1	0.9939759036144579	TTCCGTTTACGATACATAGTCTACTCTTGT	1	0.9879518072289156	AACACTCATGATGACCACACAAGGCAGA	{30928}
2.801814134296109	27469	27598	129	27469	1	0.9909638554216867	ATTACAAATTAGGAGCGTCGCAGCGTGTAG	27568	1	0.9909638554216867	CCGGTAGCAACGACAATATTGCTTTGCTAG	1	0.9849397590361446	GCACTGATTCAGGTTTTGCTGCATACAA	{27499}
2.8452000822449524	30577	30716	139	30577	1	0.9939759036144579	ACAATTTGCTCCAAGTGCCTCTGCATTCTT	30686	1	0.9909638554216867	AAAGATCCACAATTCAAAGACAACGTCATA	1	0.9939759036144579	CTTCGGGAACATGGCTGACTTATCATGG	{30639}
2.862723285568201	29703	29822	119	29703	1	0.9939759036144579	GCATTACATTTGGTGGACCCACAGATTCAA	29792	1	0.9909638554216867	GGTTTACCCAATAATACTGCGTCTTGGTTC	2	0.9879518072289156	GACGCAATGGGGCAAGGCCAAAACAGCG TAACCAGGATGGAGGACGCAGTGGTGTA	{29754} {29740}
2.927112910986066	30743	30905	162	30743	1	0.9939759036144579	AAAACATTCCCACCAACAGAGCCTAAAAAG	30875	1	0.9909638554216867	AGACAACTTCAAAATTCCATGAGTGGAGCT	1	0.9909638554216867	AAAGAAAAAGACTGATGAAGCTCAGCCT	{30778}
2.939443925003943	12944	13110	166	12944	1	0.9939759036144579	AGCTTGTACTGATGACAATGCACTTGCCTA	13080	1	0.9939759036144579	ACAGAACTGGAACCACCTTGTAGGTTTGTT	1	0.9879518072289156	TGCTGGCATTACTATCAGACCACCAAGA	{13003}
2.9563000822449523	29818	29957	139	29818	1	0.9909638554216867	GTTCACAGCTCTCACTCAGCATGGCAAGGA	29927	1	0.9939759036144579	AGAGCTACCCGACGAGTTCGTGGTGGTGAC	2	0.9909638554216867	GAACTTAGATTCCCTCGAGGCCAGGGCG GGACTCAAATTCCCTCAAGGCCAGGGAG	{29849} {29849}
