cost	target-start	target-end	target-length	left-primer-start	left-primer-num-primers	left-primer-frac-bound	left-primer-target-sequences	right-primer-start	right-primer-num-primers	right-primer-frac-bound	right-primer-target-sequences	num-guides	total-frac-bound-by-guides	guide-target-sequences	guide-target-sequence-positions
2.5126942636811997	1252	1340	88	1252	1	1.0	CACACCTGCTAAGAAACTTTGTGTTGTTCC	1310	1	1.0	ATCACCTCAACTGGTGCTGGTTGTGGTGTT	1	1.0	TGGTAATGTCGTTCCTGGTGATGTTATC	{1282}
2.5126942636811997	4001	4089	88	4001	1	1.0	GTACAGGATCCAGCACCTATTGACATTGAT	4059	1	1.0	CTGTATATTTAGGTGTTAAGGGTTCTGGTC	1	1.0	GCTTTCCCTGTGAAACCTATATGTTCAT	{4031}
2.5126942636811997	8550	8638	88	8550	1	1.0	GTTACATTTGTGGTGATGGTCTTATAGACC	8608	1	1.0	TTCATCTTTTAGCGTTGTGGCTATGTCTGG	1	1.0	TTCTTGTTAATGTACTCTCAATCTTTAG	{8580}
2.5126942636811997	9318	9406	88	9318	1	1.0	GATGTGTGGTTCGCGTCTGTTATGGTAGTA	9376	1	1.0	CACTGTTACTTGTCCTAGACATGTCATAGC	1	1.0	CTGTGCTTAATGGAGTTTGGTTAGGTGA	{9348}
2.5126942636811997	9776	9864	88	9776	1	1.0	GGTAGTGGTGCTCATGTTGGTTCTGATTTT	9834	1	1.0	ACCAACCTAGTTTGCAAGTTGAGAGTGCCA	1	1.0	ACTGGTAGTGTTTATGGTAATTTTGATG	{9806}
2.5126942636811997	10917	11005	88	10917	1	1.0	CATGGTTGCTAATGGACTTCATGCACCACA	10975	1	1.0	TTCAAACTACTTGGTATTGGTGGTGACCGT	1	1.0	TGGACCTTTTGATGCACTTTGGTTATCA	{10947}
2.5126942636811997	11327	11415	88	11327	1	1.0	ATGCTAGACAAGCTTATGAGGATGCTATTG	11385	1	1.0	ACAATTGAAGCGTGCCATGAATATCGCAAA	1	1.0	CTAATGGATCTTCTTCTCAACTTATTAA	{11357}
2.5126942636811997	12324	12412	88	12324	1	1.0	ATCTAATGGTGCTGGTAATGGTCAAGCTAT	12382	1	1.0	CAAGATTCTTATGGTGGAGCGTCTATTTGT	1	1.0	AACAACTAGTGTAGATGCTAACACCAAT	{12354}
2.5126942636811997	14491	14579	88	14491	1	1.0	ATTTCAGCCATGGTGTTGGGCTCTAAGCAT	14549	1	1.0	TTTATAGGCTTGGTAATGAGTTGGCACAAG	1	1.0	GTTAATTGTTGTACTGCAACAGATAGGT	{14521}
2.5126942636811997	14707	14795	88	14707	1	1.0	TAACAGGTTGCTTAGTGTCCCATCAGATTC	14765	1	1.0	CAACGACGTCTGTATGATAATTGCTATAGG	1	1.0	ATGTAATAATGTTAATGTTAGGGATCTA	{14737}
2.5126942636811997	16275	16363	88	16275	1	1.0	CACATTGTTCCATTGGACTTGGATTGTACT	16333	1	1.0	TTGTGCCCATGCTGCTGTTGATTCCTTATG	1	1.0	ATCCAGGTGCGCGTATTGTTTTTGTTGC	{16305}
2.5126942636811997	19739	19827	88	19739	1	1.0	ACCTTATAGGTGGATGTTGTGGTGTAAAGA	19797	1	1.0	TTGCAGTCTGCTGAATGGAAGTGTGGTTAT	1	1.0	TAACCACTTGTCCACTTTTTATCCACAG	{19769}
2.5126942636811997	23333	23421	88	23333	1	1.0	GTTTAGCAAAGTTGTTACATCTGGTTTGGG	23391	1	1.0	ACTAAAGGTCTTTCTATTGCTGACCTTGCT	1	1.0	TACTGTTGATGTTGACTATAAGTCTTGT	{23363}
2.5126942636811997	23486	23574	88	23486	1	1.0	GTACACAGGTTCTCTTATAGGTGGCATGGT	23544	1	1.0	ATACCTTTTTCTTTGGCACTGCAAGCACGA	1	1.0	GCTCGGAGGTCTTACATCAGCAGCCGCC	{23516}
2.5126942636811997	23902	23990	88	23902	1	1.0	TTGCAGCTTTGAATGCATTTGTTTCCCAAG	23960	1	1.0	TTCCAGACGCTTAGCACAGCAGAAGATTAA	1	1.0	TTTTGAATAAATATACTGAAGTTCGTAG	{23932}
2.5126942636811997	24825	24913	88	24825	1	1.0	GTGTGGCTAATCTCAAATTACCACCTCATG	24883	1	1.0	ACCTGTTACTACACTTAGTACTATCACTGC	1	1.0	ATGTTACTGTCTTGCGTGACAATCTTAA	{24855}
2.5126942636811997	25385	25473	88	25385	1	1.0	GCCGAAGAGCCTGTTGTTGGTATAGTCTAC	25443	1	1.0	CGATTAATTGATGACAATGGCATTGTCCTC	1	1.0	TCTTCTCAACTATACGAAGATGTTCCTT	{25415}
2.5126942636811997	25632	25720	88	25632	1	1.0	ATAGCACCTGTTCCAGCTGAAGTACTAAAT	25690	1	1.0	TGTGCCTCTTTCAGAGGTTTATGTCCATTT	1	1.0	GTCTAAACTAAACGATGTCTAATAGTAG	{25662}
2.5126942636811997	26018	26106	88	26018	1	1.0	GAAACTAATGCAATCATCTCTCTCCAGGTT	26076	1	1.0	TGGCTGCACCTACAGGTGTTACATTAACAC	1	1.0	TACGGACATAATTATTACTTACCGGTGA	{26048}
2.5126942636811997	26069	26157	88	26069	1	1.0	CCGGTGATGGCTGCACCTACAGGTGTTACA	26127	1	1.0	TTGATGGCCATAAGATTGCTACTCGTGTTC	1	1.0	TTAACACTTCTTAGTGGTGTACTTCTTG	{26099}
2.5126942636811997	26243	26331	88	26243	1	1.0	ACAAGCCAGACTGGTTGGGCATTCTACGTC	26301	1	1.0	TTGCCTCTCAGGAGGGTGTTTTGTCAGAAA	1	1.0	CGTGCTAAACATGGTGATTTTTCTGGTG	{26273}
2.5126942636811997	26492	26580	88	26492	1	1.0	CCCTATTGGTAAGGGTAATAAAGATGAGCA	26550	1	1.0	TGGCGTATGCGCAGGGGGCAACGTGTTGAT	1	1.0	GATTGGTTATTGGAATGTTCAAGAGCGT	{26522}
2.5126942636811997	26549	26637	88	26549	1	1.0	TTGGCGTATGCGCAGGGGGCAACGTGTTGA	26607	1	1.0	CTAGGTACTGGACCTCATAAGGACCTTAAA	1	1.0	TTTGCCTCCTAAAGTTCATTTTTATTAC	{26579}
2.5126942636811997	26844	26932	88	26844	1	1.0	TCACGAGACTCTTCTCGTAGCACTTCAAGA	26902	1	1.0	ACCAGTCTTCTTCAGATCTTGTTGCTGCTG	1	1.0	CAACAGTCTCGCACTCGTTCTGATTCTA	{26874}
2.5126942636811997	26913	27001	88	26913	1	1.0	TCAGATCTTGTTGCTGCTGTTACTTTGGCT	26971	1	1.0	CGAAGTCACCTAGTTCTTCTGGTACTTCCA	1	1.0	TTAAAGAACTTAGGTTTTGATAACCAGT	{26943}
2.5126942636811997	27152	27240	88	27152	1	1.0	AGATCTTGTTCAGAATGGTGTTGATGCCAA	27210	1	1.0	CCTAATCAGGCTGCGTTATTCTTTGATAGT	1	1.0	AGGTTTTCCACAGCTTGCTGAATTGATT	{27182}
2.5239433771173467	485	574	89	485	1	1.0	GCAAGTGATTCGGAAATTTCAGGTTTTGGT	544	1	1.0	TTATAGCGAAGCCGCTGCACAAGGTTTTCA	1	1.0	TTGCCATTCCTTCTGTAGCCGTTCGCGC	{516}
2.5239433771173467	5776	5865	89	5776	1	1.0	TAGTGTGCTTAAAGATGGTTGTGATGTTGG	5835	1	1.0	CACGTGTTAAGTTTGTTAATGGACGTGTTG	1	1.0	TTTTTGTCCACACAGACATAAATTGCGT	{5806}
2.5239433771173467	12424	12513	89	12424	1	1.0	GCCCACGTTCCTCACCCTAGTATGGATGGT	12483	1	1.0	GGTTCCTATTGGTTGTTTGGATCCTATTAG	1	1.0	TACTGTAAGTTTAAGGGTAAATGTGTTC	{12454}
2.5239433771173467	23007	23096	89	23007	1	1.0	TGGACTACTTCAGTTCAAGTTGAGTACCTC	23066	1	1.0	TTGTGCTACTTATGTGTGTAATGGTAACCC	1	1.0	CAAATTACTAGTACTCCAATAGTTGTTG	{23037}
2.5239433771173467	25771	25860	89	25771	1	1.0	GTTGCAGTATGGGCATTATAAGTATAGCAG	25830	1	1.0	TATGGTGTTTATGGCCACTTGTTCTAGCTT	1	1.0	CTTCTTTATGGTTTAAAGATGTCTGTTT	{25802}
2.534811090344213	5381	5471	90	5381	1	1.0	GGTTTTGAAAAGGCAGCACTTTTTGCTTCT	5441	1	1.0	GATTTTGTTGGTGGTTTTAGAGTTCTTGGG	1	1.0	TTGGATGTAAAGCCATATGGTTACCCTA	{5411}
2.534811090344213	5413	5503	90	5413	1	1.0	GGATGTAAAGCCATATGGTTACCCTAATGA	5473	1	1.0	CACCGACAATAATTGTTGGGTTAATGCAAC	1	1.0	TTGTTGGTGGTTTTAGAGTTCTTGGGAC	{5445}
2.534811090344213	11150	11240	90	11150	1	1.0	TTTGTGATGACCCTGAAAAAGCTCAAGGTA	11210	1	1.0	GTAAACATAGTGATTTTGGTCTTGATGGCC	1	1.0	TGTTGTTAGCACTCCTTGCGTTCTTTCT	{11180}
2.5453224201679636	8117	8208	91	8117	1	1.0	CGTATTAATGTTGTTCCTGGTGTTCCAACA	8178	1	1.0	TTACATTACAGGCTGCTTTTGGAAACACAG	1	1.0	AATGTATATTTGGTAGGAAAGACTCTTG	{8147}
2.5453224201679636	9626	9717	91	9626	1	1.0	GAAGGTATTGCATCTGGTGTTTTTGGTGTT	9687	1	1.0	CTTTTATAAATGGAGCTTGTGGTTCTCCTG	1	1.0	ATTTACGTACAAACTTTACTATTAAAGG	{9657}
2.5453224201679636	11894	11985	91	11894	1	1.0	AAAAACCTATGAAAGCTGAGGGTGATGGTG	11955	1	1.0	TACTGAGGGTGGTAAAACTTTTATGTACGC	1	1.0	GTGTTTTAGGTGATGGTAATGCCTTGTA	{11924}
2.5555	27360	27452	92	27360	1	1.0	CCCAGTTCTATCAAAGAAATGCAGTCACAA	27422	1	1.0	TGCTTCTATTCCAGAATCTAAACCATTGGC	1	1.0	CTCATGCTGTTCAGAACACAGTACTTAA	{27394}
2.565364373321448	8414	8507	93	8414	1	1.0	GCTAGAGGTTTTGGCTTACGTACTATTAGA	8477	1	1.0	TGCCGTGACTCACATAAAGGTGTTTGTTTT	1	1.0	GGCTACACGTTATTGTAGAGTTGGTGAA	{8449}
2.565364373321448	10013	10106	93	10013	1	1.0	GTGTTGAGTGCTATTCTATTTTGGCAGCAA	10076	1	1.0	CCATTCAACATCTTCATGAAGGTTTTGGTG	1	1.0	GGTGTTAGTGTTGAACAATTGTTAGCTT	{10048}
2.5749342433258255	27296	27390	94	27296	1	1.0	GCTTGTAGCTAAGGATAATAAGAACCTTCC	27360	1	1.0	CCCAGTTCTATCAAAGAAATGCAGTCACAA	1	1.0	TAAGTTCATTGAGCAGATTAGTGCTTTT	{27326}
2.5842266863651715	16346	16441	95	16346	1	1.0	GCTGTTGATTCCTTATGTGCAAAAGCTATG	16411	1	1.0	ACCTGCAAGAGCTCGGGTTGAGTGTTATAG	1	1.0	TTTATAGCATTGATAAGTGTACTAGGAT	{16380}
2.5842266863651715	22915	23010	95	22915	1	1.0	CTGATGGTTCTTTAATTCCTGTTCGTCCGC	22980	1	1.0	ACTGCTAATTTATCCATTCCCTCTAACTGG	1	1.0	GTAATTCTAGTGATAATGGTATTTCAGC	{22945}
2.5932573353204815	17234	17330	96	17234	1	1.0	ACGCACTCCTCTTAATTTACCACCAACTCA	17300	1	1.0	GACTACAGGTGATTTAGCTGTTCAAATAGG	1	1.0	CACACTTTCTTGTCGTTGTCAGATCAGT	{17268}
2.5932573353204815	25703	25799	96	25703	1	1.0	GAGGTTTATGTCCATTTACGTAACTGGAAC	25769	1	1.0	GTGTTGCAGTATGGGCATTATAAGTATAGC	1	1.0	AGTTGGAATTTAATTCTAACAGTTTTTA	{25736}
2.6020405378427527	743	840	97	743	1	1.0	GTTCTTCAGGACTTTGATGTTGTTTTTGGC	810	1	1.0	TGTGTGGTTTTGATGGTAAACCTGTGTTAC	1	1.0	CATGGTGCAGGAAGTGTGGTTTTTGTGG	{773}
2.6020405378427527	18600	18697	97	18600	1	1.0	GTGTTACCCGTTGTAATATAGGTGGTGCTG	18667	1	1.0	TGAGGCATATAATACATTTACACAGGCTGG	1	1.0	TTTGTTCAAAACATGCAAATTTGTATCA	{18630}
2.6105894934871645	710	808	98	710	1	1.0	CGAGGTTGGCTCATTTTTTCTAACAGCAAT	778	1	1.0	TGCAGGAAGTGTGGTTTTTGTGGATAAGTA	1	1.0	AGGACTTTGATGTTGTTTTTGGCCATGG	{750}
2.6237942636811997	25172	25260	88	25172	1	1.0	GTTTCAGGCAAGTGTTGGTATCTTGAACAA	25230	1	1.0	TTTATGGTGGTGACCACTATGTCGTTTTAG	2	1.0	TCATTTTATGAAAATCGTTTTGCTGCTA TCATTTTATGAAACTCGTTCTGCTGCTA	{25202} {25202}
2.6270324226839716	10077	10177	100	10077	1	1.0	CATTCAACATCTTCATGAAGGTTTTGGTGG	10147	1	1.0	ACACTAGCTGAAGTTGTGAAGCAGATGTAT	1	1.0	TGGTTATTCTAGTTTATGTGATGAGTTT	{10119}
2.6426729313414405	21941	22043	102	21941	1	1.0	GACGGTTGCATTTGCTACTTTTGTTGATGT	22013	1	1.0	TTGCGATTCTCCATTTGAAAAGTTGCAGTG	1	1.0	TTTGGTTAATGTTAGTGCAACTAAGATT	{21971}
2.6502160284948064	26285	26388	103	26285	1	1.0	GGTGATTTTTCTGGTGTTGCCTCTCAGGAG	26358	1	1.0	CTAAACAAAATGGCTAGTGTAAATTGGGCC	1	1.0	GGTGTTTTGTCAGAAAGAGAGAAGTTGC	{26315}
2.6575857056612073	7712	7816	104	7712	1	1.0	CTTTCTCAAGAGGGTAAGAAGTACCTTGTT	7786	1	1.0	TGATAACCAAGCAATTACACAAGTTCCTGC	1	1.0	AAAACAACAAAAGCAAAGGGTTTGACTT	{7742}
2.6647897580044537	19810	19915	105	19810	1	1.0	AATGGAAGTGTGGTTATGCTATGCCACAAA	19885	1	1.0	ATTATGGTGCTGGTATTAAGTTGCCTAGTG	1	1.0	TTTATAAGCTTCAGCGTATGTGTTTGGA	{19840}
2.6666	16615	16707	92	16615	1	1.0	ACAACAACTTCCTGCACCTAGAGTAATGAT	16677	1	1.0	ACGTTGTTACTCAACGTATGTGTGCTATAG	2	1.0	TACTAAAGGTGTTATGGAGCCTATCGAT TACTAAAGGTGTTATGGAGCCTGTTGAT	{16645} {16645}
2.6718354666358684	12187	12293	106	12187	1	1.0	CAAGCTGGTAAACAAACTGAATTGGCTGTT	12263	1	1.0	CTACTTACTTGGAAGCTGTTAAACATGGTG	1	1.0	AATTCTGGACTTTTAACTGCTTGTGCTT	{12217}
2.678729642842771	3017	3124	107	3017	1	1.0	GTTTTTGTTGAACCTAAGGATGGTGGTCAA	3094	1	1.0	TTATCCAGCTTCATGTAATGGTGTATTGCC	1	1.0	TTTTTTGTTTCTGGTGATTATCTTTGGT	{3047}
2.678729642842771	12534	12641	107	12534	1	1.0	GTGTAATGTTTGTGGTTGTTGGTTGGGACA	12611	1	1.0	ATTTAAACGAGCAAGGGGTTCTAGTGCAGC	1	1.0	GGTGTGCTTGTGACCGTACAACTATTCA	{12566}
2.685478667660241	3777	3885	108	3777	1	1.0	CACTTGGTGATAGTGGTAAACTTCTTAGTG	3855	1	1.0	GTGATTGTGGTAAAAAGTTTGATGAGCAGG	1	1.0	ACTTCTTAAAGAAAAATATACATGTTCT	{3808}
2.685478667660241	21730	21838	108	21730	1	1.0	GCCCTTCCTCTCAACCTTATTACTGTTTTA	21808	1	1.0	TACCACCCACTGTGCGTGAGATTGTTGTTG	1	1.0	CCACTCATGTTAGCACTTTTGTGGGTGT	{21778}
2.6953266863651715	20560	20655	95	20560	1	1.0	GTAAACATAAGGCCACTGTTGTTGTTACAC	20625	1	1.0	TTGATTAAGAGTGGTAGGTTGTTGTTACGC	2	1.0	AGATAATGATGTAAATGATATGGTTTTG AGATAGTGATGTAAATGATATGGTTTTG	{20594} {20594}
2.6985648453679434	3102	3212	110	3102	1	1.0	CTTCATGTAATGGTGTATTGCCAGTTGCTT	3182	1	1.0	CATGATGTTGAACCTACCCATAAAGTCAAG	1	1.0	TACAAAATTAGCAGGTGGTAAAATATCT	{3133}
2.6985648453679434	24782	24892	110	24782	1	1.0	GGTGGCCTATTTCAACTTACTCTTGAAAGT	24862	1	1.0	TGTCTTGCGTGACAATCTTAAACCTGTTAC	1	1.0	ACTATTAATAAGAGTGTGGCTAATCTCA	{24812}
2.7111377053709504	9928	10040	112	9928	1	1.0	GTGGTTGCGTTCAACTAGAGTTAATGTTGA	10010	1	1.0	CTAGTGTTGAGTGCTATTCTATTTTGGCAG	1	1.0	GGCTATGGCTAATGGTTATACAAGTGTT	{9981}
2.7111377053709504	23773	23885	112	23773	1	1.0	CTCTTAACCATCTCACTTCACAATTGAGAC	23855	1	1.0	TTCAATTCAAGCCGATCAACAAGTTGACAG	1	1.0	TAATTCAATTCAAGCTATTTATGACCGG	{23822}
2.7131405378427527	519	616	97	519	1	1.0	CCATTCCTTCTGTAGCCGTTCGCACTTATA	586	1	1.0	TGTTGCTTTTGGCTTACAGGATTGTGTAAC	2	1.0	GCGAAGCCGCTGCACAAGGTTTTCAGGC GCGAAGCCGCTGCGCAAGGTTTTCAGGC	{549} {549}
2.7172439250039426	12382	12495	113	12382	1	1.0	CAAGATTCTTATGGTGGAGCGTCTATTTGT	12465	1	1.0	TAAGGGTAAATGTGTTCAGGTTCCTATTGG	1	1.0	TTGTATTGTCGGGCCCACGTTCCTCACC	{12412}
2.7172439250039426	26316	26429	113	26316	1	1.0	GTGTTTTGTCAGAAAGAGAGAAGTTGCTTC	26399	1	1.0	TGCTAGGAAGAAATTTCCTCCTCCTTCATT	1	1.0	CTAGTGTAAATTGGGCCGATGACAGAGC	{26371}
2.7216894934871645	17198	17296	98	17198	1	1.0	CTCTAGCCAGGTTTGTGGCTTGTTTAAAAA	17266	1	1.0	CACACACTTTCTTGTCGTTGTCAGATCAGT	2	1.0	ACTCCTCTTAATCTACCACCAACTCAAG ACTCCTCTTAATTTACCACCAACTCATG	{17238} {17238}
2.729118128345179	907	1022	115	907	1	1.0	CACTTATCAACTAGCATGGGATGTTATACG	992	1	1.0	CTTGGTACTACAGGTCATACTTTGAAGTCT	1	1.0	AAAGACCTTTCTTATGAACAGCAAAATG	{938}
2.7381324226839716	1003	1103	100	1003	1	1.0	AGGTCATACTTTGAAGTCTGGTTGCAAACT	1073	1	1.0	TTGAGTGGTGAATGGAATGCTGTGTATAGG	2	1.0	AGCCTCCTAAATATTCATCTAAGGTTGT ATTAATGCCAAGCCGCCTAAATATTCTT	{1044} {1034}
2.7405681611474058	15547	15664	117	15547	1	1.0	GTATGTATGTAATGCATCAGGTTGTGGTGT	15634	1	1.0	ACCACAGTTGTCTTTTCCATTATGTTCAGC	1	1.0	GTGATGTAAAAAAATTGTATCTTGGTGG	{15579}
2.7405681611474058	18228	18345	117	18228	1	1.0	TTGTGCTGTTACTGATGCCAAATGGTACTG	18315	1	1.0	CCCATGGTCAACTTGATGGTCTTTGTCTAT	1	1.0	GTCAAGTTGTTGGATTATGATTATGCAA	{18287}
2.7405681611474058	24111	24228	117	24111	1	1.0	GATTACAAGAATGTAAAGGCGTGGTCGGGT	24198	1	1.0	TCTGATAATGGTGTCTTTCGTGTAACTTCC	1	1.0	GGCTATGTTCTGCGTCAACCTAACTTGG	{24162}
2.7461433771173467	1204	1322	118	1204	1	1.0	GAGTTGGAGTGTTGGTGCATGGGATGGTTA	1292	1	1.0	GTTCCTGGTGATGTGATCATCACCTCAACT	1	1.0	CTTATCTTCTTGTTGTGGCACACCTGCT	{1234}
2.7461433771173467	13676	13794	118	13676	1	1.0	CACACTCAGTTAGGTTGACAATTACTGAAC	13764	1	1.0	TCAACGCACTATTTGTTTTTCTGTTGCAGC	1	1.0	TTGCAATTTGTCACCGACCCTTCCTTGA	{13708}
2.7461433771173467	14765	14883	118	14765	1	1.0	CAACGACGTCTGTATGATAATTGCTATAGG	14853	1	1.0	TTTCAATGATGATTCTCTCTGATGACGGTG	1	1.0	TTAACTAGTGTTGAAGAGTCATTCATTG	{14795}
2.7461433771173467	19025	19143	118	19025	1	1.0	TGGGATTATGAAGCTGAAAGACCTTTTACC	19113	1	1.0	TTGACAATAGTATTCAGGGTTCGTATGAGC	1	1.0	TCATATACTAAGAGTGTATGTAAATACA	{19055}
2.7461433771173467	26018	26136	118	26018	1	1.0	GAAACTAATGCAATCATCTCTCTCCAGGTT	26106	1	1.0	TTCTTAGTGGTGTACTTCTTGTTGATGGCC	1	1.0	TACGGACATAATTATTACTTACCGGTGA	{26048}
2.757011090344213	811	931	120	811	1	1.0	GTGTGGTTTTGATGGTAAACCTGTGTTACC	901	1	1.0	TGGTGTCACTTATCAACTAGCATGGGATGT	1	1.0	TAAAAACATGTGGGAATTTAGGGATTAC	{841}
2.7623098364064735	25081	25202	121	25081	1	1.0	GCTGTTGTTTCGATTCATACATGTTGGCTA	25172	1	1.0	GTTTCAGGCAAGTGTTGGTATCTTGAACAA	1	1.0	GCCTATCTCTATAAAAATTTTTCATTTG	{25115}
2.7726515990016813	9884	10007	123	9884	1	1.0	GTTGTTGCCTTTTTGTATGCTGCTTTGTTG	9977	1	1.0	AATGGGCTATGGCTAATGGTTATACAAGTG	1	1.0	AATGGTTGTAGGTGGTGGTTGCGTTCAA	{9914}
2.7726515990016813	10600	10723	123	10600	1	1.0	GTGTGTTCTCTTATAGCAGTTGCTTACACT	10693	1	1.0	TGGTACATTGGTGCCATTGTTTTTAGGTTG	1	1.0	TATGTTTTTATGTGCTATATCTAGTGAT	{10665}
2.7777	3194	3318	124	3194	1	1.0	CCTACCCATAAAGTCAAGCTCATATTTGAG	3288	1	1.0	GTGATTGGGAAGGTCTACATGAAGTTCTTA	1	1.0	TGAAGATGATGTTGTTACCAGTCTTTGT	{3226}
2.7777	9400	9524	124	9400	1	1.0	CATAGCACCATCAACCACTGTTCTTATTGA	9494	1	1.0	TTGGGAGTTGTTGGTGTTACAATGCATGGT	1	1.0	TGCGTTTGCATAATTTTTCAGTGTCTCA	{9453}
2.782670128054922	11628	11753	125	11628	1	1.0	GTCAGTTATACCTGCAACTTCAGCTTCCAA	11723	1	1.0	ATGCTGGAGTTGTTTGGACACTTAATGATG	1	1.0	TTCTAAGATTGTTTGTGATGGTTCTGTT	{11691}
2.782670128054922	11725	11850	125	11725	1	1.0	GCTGGAGTTGTTTGGACACTTAATGATGTT	11820	1	1.0	ATGGCCTCTTATCCTTAATTGTGAACGTGT	1	1.0	TTACAAAGGAAAATGTTGAAACTTTGAC	{11792}
2.782670128054922	15806	15931	125	15806	1	1.0	GCGGCTGAAACTATTAAAGCTAAAGAAGAG	15901	1	1.0	TAGTTGGGAAAGTGGTAAAGTTAAACCACC	1	1.0	TAAAGAGGTTGTGGGACCTAAAGAATTG	{15868}
2.782670128054922	22915	23040	125	22915	1	1.0	CTGATGGTTCTTTAATTCCTGTTCGTCCGC	23010	1	1.0	ACTACTTCAGTTCAAGTTGAGTACCTCCAA	1	1.0	GTAATTCTAGTGATAATGGTATTTCAGC	{22945}
2.7875643733214486	17097	17223	126	17097	1	1.0	GTTGCTATAACACGTGCTAAGAAGGGTATA	17193	1	1.0	TTACACTCTAGCCAGGTTTGTGGCTTGTTT	1	1.0	TTTGTGTAATGTGTGATAAAACTTTGTT	{17128}
2.792385018119717	24014	24141	127	24014	1	1.0	TAGATATGGTTTTTGTGGCAATGGCACCCA	24111	1	1.0	GATTACAAGAATGTAAAGGCGTGGTCGGGT	1	1.0	ATCGTCAACTCAGCTCCAGATGGTTTGC	{24054}
2.7971342433258255	19746	19874	128	19746	1	1.0	AGGTGGATGTTGTGGTGTAAAGATAACCAC	19844	1	1.0	TAAGCTTCAACGTATGTGTTTGGAACCTTG	1	1.0	TTGTCCACTTTTTATCCACAGTTGCAGT	{19776}
2.7971342433258255	22812	22940	128	22812	1	1.0	GGCTTGCAAAACTTACTACAGTTACCTAAC	22910	1	1.0	TTGTGCTGATGGTTCTTTAATTCCTGTTCG	1	1.0	TTATTATGTTAGTAATGGTGGTAACAAT	{22844}
2.801814134296109	7830	7959	129	7830	1	1.0	CAAAACAGGGTGCTGGTTTTAAACGTACTT	7929	1	1.0	CAACCACTGTAACTAGCTTTCATGGTTATG	1	1.0	CTGTGGTATGTATGTTTATTTGTTGTTG	{7868}
2.801814134296109	14924	15053	129	14924	1	1.0	GCAGACATTAGTGCTTTTAAAGCCACTTTG	15023	1	1.0	CATGAGTTTTGTTCCCAGCATACTATGCAA	1	1.0	GGTTGAAGAAGATTTAACTAAGGGACCA	{14995}
2.8064266863651715	710	840	130	710	1	1.0	CGAGGTTGGCTCATTTTTTCTAACAGCAAT	810	1	1.0	TGTGTGGTTTTGATGGTAAACCTGTGTTAC	1	1.0	AGGACTTTGATGTTGTTTTTGGCCATGG	{750}
2.8064266863651715	10917	11047	130	10917	1	1.0	CATGGTTGCTAATGGACTTCATGCACCACA	11017	1	1.0	TCAACTGTCCAATCCAAACTGACTGATTTG	1	1.0	TGGACCTTTTGATGCACTTTGGTTATCA	{10947}
2.8154573353204815	17198	17330	132	17198	1	1.0	CTCTAGCCAGGTTTGTGGCTTGTTTAAAAA	17300	1	1.0	GACTACAGGTGATTTAGCTGTTCAAATAGG	1	1.0	CCAACTCAAGCACACACTTTCTTGTCGT	{17256}
2.8154573353204815	21941	22073	132	21941	1	1.0	GACGGTTGCATTTGCTACTTTTGTTGATGT	22043	1	1.0	TGAGCACTTGCAGTTTGGATTGCAAGATGG	1	1.0	TTTGGTTAATGTTAGTGCAACTAAGATT	{21971}
2.81987901698314	21818	21951	133	21818	1	1.0	TGTGCGTGAGATTGTTGTTGCTAGAACTGG	21921	1	1.0	GCTAGTGCCACAGATTTTTGGACGGTTGCA	1	1.0	TAATGGTTTTAAGTATTTTGATTTGGGT	{21860}
2.8242405378427526	7712	7846	134	7712	1	1.0	CTTTCTCAAGAGGGTAAGAAGTACCTTGTT	7816	1	1.0	TACTAGTATAGTTGCAAAACAGGGTGCTGG	1	1.0	AAAACAACAAAAGCAAAGGGTTTGACTT	{7742}
2.8242405378427526	9786	9920	134	9786	1	1.0	CTCATGTTGGTTCTGATTTTACTGGTAGTG	9890	1	1.0	GCCTTTTTGTATGCTGCTTTGTTGAATGGT	1	1.0	CTAGTTTGCAAGTTGAGAGTGCCAACCT	{9840}
2.8242405378427526	15985	16119	134	15985	1	1.0	CCAAATAGGTGAGTTCATCTTTGAGAAGGT	16089	1	1.0	TAACATCTCACAATGTCCAACCTTTACGTG	1	1.0	TGATACTGTTACGTATAAGTCTACTGTA	{16027}
2.8285435130281846	953	1088	135	953	1	1.0	GAACAGCAAAATGTTTTAGCCATTGAGAGC	1058	1	1.0	TCTTCTAAGGTTGTTTTGAGTGGTGAATGG	1	1.0	TTCATTATCTTGGTACTACAGGTCATAC	{984}
2.8285435130281846	11150	11285	135	11150	1	1.0	TTTGTGATGACCCTGAAAAAGCTCAAGGTA	11255	1	1.0	TTGATAATAGTAGCACCCTTCAGAGTGTTG	1	1.0	TGTTGTTAGCACTCCTTGCGTTCTTTCT	{11180}
2.8285435130281846	11277	11412	135	11277	1	1.0	GAGTGTTGCTTCATCATTTGTTAGTATGCC	11382	1	1.0	TAAACAATTGAAGCGTGCCATGAATATCGC	1	1.0	GAGGATGCTATTGCTAATGGATCTTCTT	{11344}
2.8327894934871645	8414	8550	136	8414	1	1.0	GCTAGAGGTTTTGGCTTACGTACTATTAGA	8520	1	1.0	GGTATGTTAATGATGGACGTGTTGATGACG	1	1.0	GGCTACACGTTATTGTAGAGTTGGTGAA	{8449}
2.8327894934871645	14507	14643	136	14507	1	1.0	TGGGCTCTAAGCATGTTAATTGTTGTACTG	14613	1	1.0	TTTATTTTAAGCCAGGTGGTACGACTTCTG	1	1.0	CAACAGATAGGTTTTATAGGCTTGGTAA	{14537}
2.8327894934871645	20454	20590	136	20454	1	1.0	CCTTTTATAGCTGGTAACACTGTTCATGCT	20560	1	1.0	GTAAACATAAGGCCACTGTTGTTGTTACAC	1	1.0	TGTCTTTGTCATATAATTCAGTTTTAGA	{20515}
2.8327894934871645	25712	25848	136	25712	1	1.0	GTCCATTTACGTAACTGGAACTTTAGTTGG	25818	1	1.0	AGATGTCTGTTTTATGGTGTTTATGGCCAC	1	1.0	TTGTGTTGCAGTATGGGCATTATAAGTA	{25767}
2.836979969342407	12534	12671	137	12534	1	1.0	GTGTAATGTTTGTGGTTGTTGGTTGGGACA	12641	1	1.0	TCGACTAGAACCCTGTAATGGCACGGACAT	1	1.0	GGTGTGCTTGTGACCGTACAACTATTCA	{12566}
2.836979969342407	26619	26756	137	26619	1	1.0	CCTCATAAGGACCTTAAATTCAGACAACGT	26726	1	1.0	GAAACCTTTGGAACCAAAGTTCTCTATTGC	1	1.0	ATACCAGTCTTGGTAATCGCAAACGTAA	{26695}
2.836979969342407	27445	27582	137	27445	1	1.0	CATTGGCTGATGATGATTCAGCCATTATAG	27552	1	1.0	GCGTTTAGCGCATGATAAGGGTTTAGTCTT	1	1.0	CAACGAGGTTTTGCATTAAATTGTTTTG	{27482}
2.8411163730311917	7575	7713	138	7575	1	1.0	CTTATGCTAAACCTGAAGATAAGTTGTCCG	7683	1	1.0	TTGTTTGGGGTGTCAAGGACTTTAATACTC	1	1.0	CATAATGTTTTAATCAAAGAGTCGATAC	{7652}
2.8411163730311917	23353	23491	138	23353	1	1.0	CTGGTTTGGGTACTGTTGATGTTGACTATA	23461	1	1.0	TTGCTGATGCTGAACGTATGGCCATGTACA	1	1.0	AGTCTTGTACTAAAGGTCTTTCTATTGC	{23383}
2.8411163730311917	23904	24042	138	23904	1	1.0	GCAGCTTTGAATGCATTTGTTTCCCAAGTT	24012	1	1.0	AATAGATATGGTTTTTGTGGCAATGGCACC	1	1.0	CTGAAGTTCGTAGTTCCAGACGCTTAGC	{23947}
2.8452000822449524	597	736	139	597	1	1.0	GCTTACAGGATTGTGTAACCGGTATTAATG	706	1	1.0	TTTGCGAGGTTGGCTCATTTTTTCTAACAG	1	1.0	ATGATGATTATGTCATTGCATTGACTGG	{627}
2.849232422683972	14635	14775	140	14635	1	1.0	GACTTCTGGTGACGCTAGTACAGCTTATGC	14745	1	1.0	ATGTTAATGTTAGGGATCTACAACGACGTC	1	1.0	TAACATTAACAGGTTGTTTAGTGTCCCA	{14701}
2.849232422683972	26568	26708	140	26568	1	1.0	CAACGTGTTGATTTGCCTCCTAAAGTTCAT	26678	1	1.0	AGGTGCTAAAACTGTTAATACCAGTCTTGG	1	1.0	CATAAGGACCTTAAATTCAGACAACGTT	{26622}
2.8516681611474057	11919	12036	117	11919	1	1.0	TGGTGGTGTTTTAGGTGATGGTAATGCCTT	12006	1	1.0	CCTTAAATTTGTTAAGTGGGAGTATGAGGG	2	1.0	GTATAATACTGAGGGTGGTAAAACTTTT TAAAACTTTTATGTATGCTTATATTTCT	{11949} {11967}
2.8532146706409636	2902	3043	141	2902	1	1.0	CATGACTTTTCCTTGTGTTAGTTGTGTCAC	3013	1	1.0	AACTGTTTTTGTTGAACCTAAGGATGGTGG	1	1.0	TTTTTCTATGAATTTTTAGACACTTGTT	{2933}
2.8571480554261384	23773	23915	142	23773	1	1.0	CTCTTAACCATCTCACTTCACAATTGAGAC	23885	1	1.0	ATTAATTACTGGACGGCTTGCAGCTTTGAA	1	1.0	TAATTCAATTCAAGCTATTTATGACCGG	{23822}
2.8610337616452868	13805	13948	143	13805	1	1.0	GTTTGACAAATCAAGTTGTTAAGCCAGGTC	13918	1	1.0	TTCGCACAGAATGGTGATGCTGCTGTTAAA	1	1.0	ATGAAGAGTTTTATAACTTTCTTCGTTT	{13841}
2.8610337616452868	23564	23707	143	23564	1	1.0	GCAAGCACGACTTAACTATGTTGCTTTACA	23677	1	1.0	GCGTTAATGATGCTATTACACAAACTGCAG	1	1.0	AAGGCTATTAATAACATTGTTGCTTCTT	{23643}
2.8648729313414405	11096	11240	144	11096	1	1.0	CAGCTAATTCTAGTGAATGGGCTTATTGTG	11210	1	1.0	GTAAACATAGTGATTTTGGTCTTGATGGCC	1	1.0	GACCCTGAAAAAGCTCAAGGTATGTTGT	{11158}
2.8648729313414405	24706	24850	144	24706	1	1.0	GAGGTTGTTGTGATTGTGGTTCAACTAAAC	24820	1	1.0	TAAGAGTGTGGCTAATCTCAAATTACCACC	1	1.0	GTCCACGTTCAATAATGCCTTTCGGTGG	{24759}
2.868111090344213	24080	24200	120	24080	1	1.0	GCTTTTTCTTCATACTGTTTTGCTGCCAAC	24170	1	1.0	TCTGCGTCAACCTAACTTGGTTCTTTATTC	2	1.0	CAAGAATGTAAAGGCGTGGTCGGGTATC CGGGTATCTGTGTTGATGGCATCTATGG	{24116} {24136}
2.8686666660097973	9500	9645	145	9500	1	1.0	GTTGTTGGTGTTACAATGCATGGTTCTGTG	9615	1	1.0	TAGCATGTTATGAAGGTATTGCATCTGGTG	1	1.0	TTGCGTATTAAGGTTTCACAATCTAATG	{9530}
2.8724160284948064	3863	4009	146	3863	1	1.0	GGTAAAAAGTTTGATGAGCAGGTTGGTTGT	3979	1	1.0	TATGAAAGGTACTGGTGTGTTTGTACAGGA	1	1.0	TGTTTTGGATTATGCCTTACACAAAACT	{3894}
2.8724160284948064	16795	16941	146	16795	1	1.0	CCCTGTTAAACCTGCTAGTAAACAGTGTTT	16911	1	1.0	GTTAAAAATCCAAGTTGGAGTAAGGCTGTG	1	1.0	AGAAAGCAGCTTGAAATAGTTAAGCTGT	{16878}
2.8734098364064735	15693	15814	121	15693	1	1.0	CAGCAACTGGTTCCTTAGATGTTGAAGTTT	15784	1	1.0	TAAAGATACACTTAGACTCTTTGCGGCTGA	2	1.0	TTAATAGGCTTGCAACGTCTGATTGGAC TTAATATGCTTGCAACGTCTGATAGGAC	{15723} {15723}
2.876122044777587	13606	13753	147	13606	1	1.0	GTTCCACTTGTTACAACTGCTGGTTATCAT	13723	1	1.0	GACCCTTCCTTGATAATAGCTTCTTCCCCA	1	1.0	TAAAGATGTTAACACACACTCAGTTAGG	{13662}
2.876122044777587	18832	18979	147	18832	1	1.0	GTTACCTGTTGCAGTTGTTAACGACAAAGT	18949	1	1.0	ACGAAAAATGGGTTTAACACCACCATTGTC	1	1.0	TCGCTATGGCGATGTTGACAACTTGGTT	{18868}
2.8797857056612073	12277	12425	148	12277	1	1.0	GCTGTTAAACATGGTGCAAAACCTGTAAGT	12395	1	1.0	GTGGAGCGTCTATTTGTTTGTATTGTCGGG	1	1.0	GGTCAGGCTATAACAACTAGTGTAGATG	{12343}
2.8834079683607334	1204	1353	149	1204	1	1.0	GAGTTGGAGTGTTGGTGCATGGGATGGTTA	1323	1	1.0	GTGCTGGTTGTGGTGTTAAATACTATGCTG	1	1.0	CTTATCTTCTTGTTGTGGCACACCTGCT	{1234}
2.8834079683607334	5857	6006	149	5857	1	1.0	ACGTGTTGTTATTACCAATGTTGGTGAACC	5976	1	1.0	ATGCTGCTAATAATGCTGTCTATGATGGTG	1	1.0	TTTGATAACGGTCACTATGTAGTTTATG	{5948}
2.8869897580044537	3328	3478	150	3328	1	1.0	GAATGTCATTGGGCAACATATTAAGTTGCC	3448	1	1.0	TTGTGTTGTTGAAGCGAGCACTGATTTTCA	1	1.0	GTTATGATGTTTCTAAACCAGTTATGAT	{3387}
2.8869897580044537	3648	3798	150	3648	1	1.0	GTACCACACTTGTACAGTTGCAACTTACAA	3768	1	1.0	TTAGTGGTTCACTTGGTGATAGTGGTAAAC	1	1.0	TTTGGATGATTCTATTGAGATGCAATTG	{3682}
2.8869897580044537	9928	10078	150	9928	1	1.0	GTGGTTGCGTTCAACTAGAGTTAATGTTGA	10048	1	1.0	GGTGTTAGTGTTGAACAATTGTTAGCTTCC	1	1.0	GGCTATGGCTAATGGTTATACAAGTGTT	{9981}
2.8869897580044537	24080	24230	150	24080	1	1.0	GCTTTTTCTTCATACTGTTTTGCTGCCAAC	24200	1	1.0	TGATAATGGTGTCTTTCGTGTAACTTCCAG	1	1.0	GGCTATGTTCTGCGTCAACCTAACTTGG	{24162}
2.8940354666358683	779	931	152	779	1	1.0	GCAGGAAGTGTGGTTTTTGTGGATAAGTAT	901	1	1.0	TGGTGTCACTTATCAACTAGCATGGGATGT	1	1.0	TTGATGGTAAACCTGTGTTACCTAAAAA	{819}
2.8975010878282044	5648	5801	153	5648	1	1.0	GCTGAAGAGGCATTATCTAAATTGTCAGAG	5771	1	1.0	TGTGCTAGTGTGCTTAAAGATGGTTGTGAT	1	1.0	TGGTGATTCTATTGTTACTCTTGAACAA	{5686}
2.8975010878282044	23152	23305	153	23152	1	1.0	CCTTACGACTTAGTGCTCATTTGGAAACTA	23275	1	1.0	CTCAGAGAAACATTCATTCAAGCCGTATAG	1	1.0	ATGTTAGTAGTATGCTAACTTTCGATAG	{23185}
2.900929642842771	3194	3348	154	3194	1	1.0	CCTACCCATAAAGTCAAGCTCATATTTGAG	3318	1	1.0	CATCTGCAATGAATGTCATTGGGCAACATA	1	1.0	TGAAGATGATGTTGTTACCAGTCTTTGT	{3226}
2.9043219161711367	8480	8635	155	8480	1	1.0	CGTGACTCACATAAAGGTGTTTGTTTTGGT	8605	1	1.0	TAGTTCATCTTTTAGCGTTGTGGCTATGTC	1	1.0	GTGGTGATGGTCTTATAGACCTTCTTGT	{8559}
2.907678667660241	9701	9857	156	9701	1	1.0	GCTTGTGGTTCTCCTGGTTATAATGTTAGA	9827	1	1.0	TTTGATGACCAACCTAGTTTGCAAGTTGAG	1	1.0	ATGTTGGTTCTGATTTTACTGGTAGTGT	{9789}
2.907678667660241	13676	13832	156	13676	1	1.0	CACACTCAGTTAGGTTGACAATTACTGAAC	13802	1	1.0	CTGGTTTGACAAATCAAGTTGTTAAGCCAG	1	1.0	TTGCAATTTGTCACCGACCCTTCCTTGA	{13708}
2.907678667660241	25236	25392	156	25236	1	1.0	GTGGTGACCACTATGTCGTTTTAGGTGGTG	25362	1	1.0	ATGGTGCTGTCATTTACATTTTTGCCGAAG	1	1.0	CTATTAGAGGTTCTTGTGAAAAGAACCT	{25305}
2.91100063353398	12484	12641	157	12484	1	1.0	GTTCCTATTGGTTGTTTGGATCCTATTAGG	12611	1	1.0	ATTTAAACGAGCAAGGGGTTCTAGTGCAGC	1	1.0	GGTGTGCTTGTGACCGTACAACTATTCA	{12566}
2.91100063353398	23011	23168	157	23011	1	1.0	CTACTTCAGTTCAAGTTGAGTACCTCCAAA	23138	1	1.0	AACTATTGAAGATGCCTTACGACTTAGTGC	1	1.0	AGTACTCCAATAGTTGTTGATTGTGCTA	{23046}
2.9142885273623995	825	983	158	825	1	1.0	GTAAACCTGTGTTACCTAAAAACATGTGGG	953	1	1.0	GAACAGCAAAATGTTTTAGCCATTGAGAGC	1	1.0	GGTGTCACTTATCAATTAGCATGGGATG	{902}
2.9142885273623995	11480	11638	158	11480	1	1.0	CTCAGATGTATAAAGAAGCACGCTCTGTTA	11608	1	1.0	CGTGATGGTGTTGTGCCATTGTCAGTTATA	1	1.0	TAGTGTTGAAACTGTTTTGAATTTAGCA	{11580}
2.9142885273623995	13922	14080	158	13922	1	1.0	CACAGAATGGTGATGCTGCTGTTAAAGATT	14050	1	1.0	GGCTGTATTAAGGCATGTGAAGTTGTTGTA	1	1.0	GTCAAGCTAGAGTTACATATAAGATAGT	{13994}
2.920764845367944	8048	8208	160	8048	1	1.0	CATGAGGCTAAGTTTGGTGTTGTTACTACT	8178	1	1.0	TTACATTACAGGCTGCTTTTGGAAACACAG	1	1.0	CCTATAGTTGTTGGTGTTTCAGAGCGTG	{8093}
2.920764845367944	26316	26476	160	26316	1	1.0	GTGTTTTGTCAGAAAGAGAGAAGTTGCTTC	26446	1	1.0	TTAGTTCTGATAAGGCACCATATAGGGTCA	1	1.0	CTAGTGTAAATTGGGCCGATGACAGAGC	{26371}
2.923954591467449	9626	9787	161	9626	1	1.0	GAAGGTATTGCATCTGGTGTTTTTGGTGTT	9757	1	1.0	TTTACACCAAATTGAGTTAGGTAGTGGTGC	1	1.0	ATTTACGTACAAACTTTACTATTAAAGG	{9657}
2.923954591467449	16346	16507	161	16346	1	1.0	GCTGTTGATTCCTTATGTGCAAAAGCTATG	16477	1	1.0	ATTTAGCACTGTTAACGCATTACCTGAGTG	1	1.0	TTTATAGCATTGATAAGTGTACTAGGAT	{16380}
2.923954591467449	25638	25799	161	25638	1	1.0	CCTGTTCCAGCTGAAGTACTAAATGTCTAA	25769	1	1.0	GTGTTGCAGTATGGGCATTATAAGTATAGC	1	1.0	TAAACGATGTCTAATAGTAGTGTGCCTC	{25670}
2.927112910986066	11823	11985	162	11823	1	1.0	GCCTCTTATCCTTAATTGTGAACGTGTTGT	11955	1	1.0	TACTGAGGGTGGTAAAACTTTTATGTACGC	1	1.0	TGGTGGTGTTTTAGGTGATGGTAATGCC	{11919}
2.930240417140111	1102	1265	163	1102	1	1.0	GGCGTTTGGTTCACCATTTATTACAAATGG	1235	1	1.0	TTATCTTCTTGTTGTGGCACACCTGCTAAG	1	1.0	TATGTCATTGCTAGATATAATTGTTAAA	{1132}
2.9333377053709504	7830	7994	164	7830	1	1.0	CAAAACAGGGTGCTGGTTTTAAACGTACTT	7964	1	1.0	AAGTACATTGAGAATGGTCAGTTGAAGGTG	1	1.0	CTGTGGTATGTATGTTTATTTGTTGTTG	{7868}
2.9333377053709504	9786	9950	164	9786	1	1.0	CTCATGTTGGTTCTGATTTTACTGGTAGTG	9920	1	1.0	TGTAGGTGGTGGTTGCGTTCAACTAGAGTT	1	1.0	CTAGTTTGCAAGTTGAGAGTGCCAACCT	{9840}
2.9333377053709504	18668	18832	164	18668	1	1.0	GAGGCATATAATACATTTACACAGGCTGGT	18802	1	1.0	AAAAGGGTGTTTTACTGGTGTTGATGGTGA	1	1.0	AATATTTGGGTACCACATAGTTTTGATG	{18701}
2.9364053540254123	11334	11499	165	11334	1	1.0	ACAAGCTTATGAGGATGCTATTGCTAATGG	11469	1	1.0	ACAAGCTGCTACTCAGATGTATAAAGAAGC	1	1.0	ATCTTCTTCTCAACTTATTAAACAATTG	{11364}
2.9364053540254123	25081	25246	165	25081	1	1.0	GCTGTTGTTTCGATTCATACATGTTGGCTA	25216	1	1.0	TCGTTTTGCTGCTATTTATGGTGGTGACCA	1	1.0	GCCTATCTCTATAAAAATTTTTCATTTG	{25115}
2.939443925003943	8414	8580	166	8414	1	1.0	GCTAGAGGTTTTGGCTTACGTACTATTAGA	8550	1	1.0	GTTACATTTGTGGTGATGGTCTTATAGACC	1	1.0	GGCTACACGTTATTGTAGAGTTGGTGAA	{8449}
2.9424539643783345	5816	5983	167	5816	1	1.0	CACAGACATAAATTGCGTTCACGTGTTAAG	5953	1	1.0	TAACGGTCACTATGTAGTTTATGATGCTGC	1	1.0	GGACGTGTTGTTATTACCAATGTTGGTG	{5855}
2.9424539643783345	26619	26786	167	26619	1	1.0	CCTCATAAGGACCTTAAATTCAGACAACGT	26756	1	1.0	TTTGCCTCCAGAGCTCTCTGTTGTTGAGTT	1	1.0	ATACCAGTCTTGGTAATCGCAAACGTAA	{26695}
2.9424539643783345	27445	27612	167	27445	1	1.0	CATTGGCTGATGATGATTCAGCCATTATAG	27582	1	1.0	ACACACAATGGTAGGCCAGTGATAGTAAAG	1	1.0	CAACGAGGTTTTGCATTAAATTGTTTTG	{27482}
2.9454360029807227	920	1088	168	920	1	1.0	GCATGGGATGTTATACGTAAAGACCTTTCT	1058	1	1.0	TCTTCTAAGGTTGTTTTGAGTGGTGAATGG	1	1.0	GAGCATTCATTACCTTGGTACTACAGGT	{979}
2.9454360029807227	20570	20738	168	20570	1	1.0	GGCCACTGTTGTTGTTACACTTAAAGATAG	20708	1	1.0	CTTTTCTTGATTTTGCTTGTTTTGCCCCTG	1	1.0	ATATGGTTTTGAGTTTGATTAAGAGTGG	{20611}
2.948390556965433	14924	15093	169	14924	1	1.0	GCAGACATTAGTGCTTTTAAAGCCACTTTG	15063	1	1.0	AAGATGGTACCTATTATTTGCCTTACCCAG	1	1.0	GGTTGAAGAAGATTTAACTAAGGGACCA	{14995}
2.9513181283451795	14713	14883	170	14713	1	1.0	GTTGCTTAGTGTCCCATCAGATTCATGTAA	14853	1	1.0	TTTCAATGATGATTCTCTCTGATGACGGTG	1	1.0	TATGATAATTGCTATAGGTTAACTAGTG	{14777}
2.9542192055029934	19810	19981	171	19810	1	1.0	AATGGAAGTGTGGTTATGCTATGCCACAAA	19951	1	1.0	GTCAATACCTAAATAGCACTACAATGTGCG	1	1.0	TTTATAAGCTTCAGCGTATGTGTTTGGA	{19840}
2.9570942636811997	3452	3624	172	3452	1	1.0	GTTGTTGAAGCGAGCACTGATTTTCATCAA	3594	1	1.0	GAGATGAATTGGGTGTTCGTGTTTTAGATC	1	1.0	AAGAGGTTGATATAATTGAACAACCTTT	{3513}
2.9570942636811997	23704	23876	172	23704	1	1.0	CAGAGGCTATACATACTGTTACTATTGCAC	23846	1	1.0	CCGGCTTGATTCAATTCAAGCCGATCAACA	1	1.0	GGATGTTGTTAATCAACAGGGTAGTGCT	{23747}
2.9570942636811997	25842	26014	172	25842	1	1.0	GGCCACTTGTTCTAGCTTTGTCTATTTTTG	25984	1	1.0	GCGCCGTGTTAAAACTTTTTGGGCTTTTAA	1	1.0	TTTGTCAATTTTAATGTGGACTGGGTCT	{25877}
2.9570942636811997	26568	26740	172	26568	1	1.0	CAACGTGTTGATTTGCCTCCTAAAGTTCAT	26710	1	1.0	ATCGCAAACGTAATCAGAAACCTTTGGAAC	1	1.0	CATAAGGACCTTAAATTCAGACAACGTT	{26622}
2.9599437654486547	15547	15720	173	15547	1	1.0	GTATGTATGTAATGCATCAGGTTGTGGTGT	15690	1	1.0	ATTCAGCAACTGGTTCCTTAGATGTTGAAG	1	1.0	GTGATGTAAAAAAATTGTATCTTGGTGG	{15579}
2.9599437654486547	23968	24141	173	23968	1	1.0	GCTTAGCACAGCAGAAGATTAATGAATGTG	24111	1	1.0	GATTACAAGAATGTAAAGGCGTGGTCGGGT	1	1.0	ATCGTCAACTCAGCTCCAGATGGTTTGC	{24054}
2.9599437654486547	26018	26191	173	26018	1	1.0	GAAACTAATGCAATCATCTCTCTCCAGGTT	26161	1	1.0	GGGTCAGTTGCCTAAATATGTAATAGTTGC	1	1.0	TACGGACATAATTATTACTTACCGGTGA	{26048}
2.9627681611474057	18969	19143	174	18969	1	1.0	CACCATTGTCTATTCTCAAAAATCTCGGTG	19113	1	1.0	TTGACAATAGTATTCAGGGTTCGTATGAGC	1	1.0	ACCTCATATACTAAGAGTGTATGTAAAT	{19052}
2.9683433771173466	3863	4039	176	3863	1	1.0	GGTAAAAAGTTTGATGAGCAGGTTGGTTGT	4009	1	1.0	TCCAGCACCTATTGACATTGATGCTTTCCC	1	1.0	TGTTTTGGATTATGCCTTACACAAAACT	{3894}
2.9683433771173466	5473	5649	176	5473	1	1.0	CACCGACAATAATTGTTGGGTTAATGCAAC	5619	1	1.0	CTATGTCTTCAAAGGGTCAAAAGGGTGATG	1	1.0	GTGTATAATTTTACAGTATCTTAAGCCT	{5503}
2.9710950406914325	21774	21951	177	21774	1	1.0	AACACCACTCATGTTAGCACTTTTGTGGGT	21921	1	1.0	GCTAGTGCCACAGATTTTTGGACGGTTGCA	1	1.0	CCACCCACTGTGCGTGAGATTGTTGTTG	{21810}
2.9765285070070253	597	776	179	597	1	1.0	GCTTACAGGATTGTGTAACCGGTATTAATG	746	1	1.0	CTTCAGGACTTTGATGTTGTTTTTGGCCAT	1	1.0	ATGATGATTATGTCATTGCATTGACTGG	{627}
2.9765285070070253	953	1132	179	953	1	1.0	GAACAGCAAAATGTTTTAGCCATTGAGAGC	1102	1	1.0	GGCGTTTGGTTCACCATTTATTACAAATGG	1	1.0	TTCATTATCTTGGTACTACAGGTCATAC	{984}
2.9765285070070253	25467	25646	179	25467	1	1.0	GTCCTCAATTCCATTTTATGGCTCCTTGTT	25616	1	1.0	CCAAGATTATATGCAAATAGCACCTGTTCC	1	1.0	ATGATATTTTTCTTTGTGTTGGCAATGA	{25497}
2.979211090344213	22916	23096	180	22916	1	1.0	TGATGGTTCTTTAATTCCTGTTCGTCCGCG	23066	1	1.0	TTGTGCTACTTATGTGTGTAATGGTAACCC	1	1.0	AGTTGAGTACCTCCAAATTACTAGTATT	{23024}
2.9818714113224147	18228	18409	181	18228	1	1.0	TTGTGCTGTTACTGATGCCAAATGGTACTG	18379	1	1.0	TTCAATTGTGTGTCGTTTTGACACACGTAC	1	1.0	GTCAAGTTGTTGGATTATGATTATGCAA	{18287}
2.9845098364064735	10917	11099	182	10917	1	1.0	CATGGTTGCTAATGGACTTCATGCACCACA	11069	1	1.0	TGGGTTGTTTGTCTAGTATGAACATTGCAG	1	1.0	TGGACCTTTTGATGCACTTTGGTTATCA	{10947}
2.9845098364064735	16181	16363	182	16181	1	1.0	GTCAGTGATGCATATGCTAATTTGGTTCCA	16333	1	1.0	TTGTGCCCATGCTGCTGTTGATTCCTTATG	1	1.0	ATCCAGGTGCGCGTATTGTTTTTGTTGC	{16305}
2.9871267230863787	553	736	183	553	1	1.0	AGCCGCTGCACAAGGTTTTCAGGCATGCCG	706	1	1.0	TTTGCGAGGTTGGCTCATTTTTTCTAACAG	1	1.0	ATGATGATTATGTCATTGCATTGACTGG	{627}
2.9871267230863787	23904	24087	183	23904	1	1.0	GCAGCTTTGAATGCATTTGTTTCCCAAGTT	24057	1	1.0	GTCAACTCAGCTCCAGATGGTTTGCTTTTT	1	1.0	CTGAAGTTCGTAGTTCCAGACGCTTAGC	{23947}
2.992297268051916	5648	5833	185	5648	1	1.0	GCTGAAGAGGCATTATCTAAATTGTCAGAG	5803	1	1.0	TGGTTTTTGTCCACACAGACATAAATTGCG	1	1.0	TGGTGATTCTATTGTTACTCTTGAACAA	{5686}
2.992297268051916	23152	23337	185	23152	1	1.0	CCTTACGACTTAGTGCTCATTTGGAAACTA	23307	1	1.0	GGACGTAGTGCTTTGGAAGATTTGTTGTTT	1	1.0	ATGTTAGTAGTATGCTAACTTTCGATAG	{23185}
2.9948515990016813	14867	15053	186	14867	1	1.0	CTCTCTGATGACGGTGTTGTCTGTTATAAC	15023	1	1.0	CATGAGTTTTGTTCCCAGCATACTATGCAA	1	1.0	GGTTGAAGAAGATTTAACTAAGGGACCA	{14995}
2.9948515990016813	17097	17283	186	17097	1	1.0	GTTGCTATAACACGTGCTAAGAAGGGTATA	17253	1	1.0	CCACCAACTCATGCACACACTTTCTTGTCG	1	1.0	TTTGTGTAATGTGTGATAAAACTTTGTT	{17128}
2.9948515990016813	24706	24892	186	24706	1	1.0	GAGGTTGTTGTGATTGTGGTTCAACTAAAC	24862	1	1.0	TGTCTTGCGTGACAATCTTAAACCTGTTAC	1	1.0	GTCCACGTTCAATAATGCCTTTCGGTGG	{24759}
2.997385737400775	12484	12671	187	12484	1	1.0	GTTCCTATTGGTTGTTTGGATCCTATTAGG	12641	1	1.0	TCGACTAGAACCCTGTAATGGCACGGACAT	1	1.0	GGTGTGCTTGTGACCGTACAACTATTCA	{12566}
2.997385737400775	24014	24201	187	24014	1	1.0	TAGATATGGTTTTTGTGGCAATGGCACCCA	24171	1	1.0	CTGCGTCAACCTAACTTGGTTCTTTATTCT	1	1.0	ATCGTCAACTCAGCTCCAGATGGTTTGC	{24054}
2.9999	13565	13753	188	13565	1	1.0	CTGCTTTTGGTCCACTATGTCGTAAAGTTT	13723	1	1.0	GACCCTTCCTTGATAATAGCTTCTTCCCCA	1	1.0	TAAAGATGTTAACACACACTCAGTTAGG	{13662}
2.9999	13606	13794	188	13606	1	1.0	GTTCCACTTGTTACAACTGCTGGTTATCAT	13764	1	1.0	TCAACGCACTATTTGTTTTTCTGTTGCAGC	1	1.0	TAAAGATGTTAACACACACTCAGTTAGG	{13662}
2.9999	13922	14110	188	13922	1	1.0	CACAGAATGGTGATGCTGCTGTTAAAGATT	14080	1	1.0	ACAAATCTTAATAAGAGTGCTGGTTGGCCA	1	1.0	GTCAAGCTAGAGTTACATATAAGATAGT	{13994}
3.0023946961550467	11096	11285	189	11096	1	1.0	CAGCTAATTCTAGTGAATGGGCTTATTGTG	11255	1	1.0	TTGATAATAGTAGCACCCTTCAGAGTGTTG	1	1.0	GACCCTGAAAAAGCTCAAGGTATGTTGT	{11158}
3.0023946961550467	12277	12466	189	12277	1	1.0	GCTGTTAAACATGGTGCAAAACCTGTAAGT	12436	1	1.0	CACCCTAGTATGGATGGTTACTGTAAGTTT	1	1.0	GGTCAGGCTATAACAACTAGTGTAGATG	{12343}
3.0023946961550467	14765	14954	189	14765	1	1.0	CAACGACGTCTGTATGATAATTGCTATAGG	14924	1	1.0	GCAGACATTAGTGCTTTTAAAGCCACTTTG	1	1.0	TTAACTAGTGTTGAAGAGTCATTCATTG	{14795}
3.0048701280549226	15741	15931	190	15741	1	1.0	CTGATTGGACTGATGTTAGGGACTATAAAC	15901	1	1.0	TAGTTGGGAAAGTGGTAAAGTTAAACCACC	1	1.0	TAAAGAGGTTGTGGGACCTAAAGAATTG	{15868}
3.0048701280549226	26316	26506	190	26316	1	1.0	GTGTTTTGTCAGAAAGAGAGAAGTTGCTTC	26476	1	1.0	TTCCCAGGAATCTTGTCCCTATTGGTAAGG	1	1.0	CTAGTGTAAATTGGGCCGATGACAGAGC	{26371}
3.0121837571683643	15926	16119	193	15926	1	1.0	CCACCTTTGAATCGTAATTCTGTTTTCACC	16089	1	1.0	TAACATCTCACAATGTCCAACCTTTACGTG	1	1.0	TGATACTGTTACGTATAAGTCTACTGTA	{16027}
3.014585018119717	18668	18862	194	18668	1	1.0	GAGGCATATAATACATTTACACAGGCTGGT	18832	1	1.0	GTTACCTGTTGCAGTTGTTAACGACAAAGT	1	1.0	AATATTTGGGTACCACATAGTTTTGATG	{18701}
3.0169684256646945	1102	1297	195	1102	1	1.0	GGCGTTTGGTTCACCATTTATTACAAATGG	1267	1	1.0	ACTTTGTGTTGTTCCTGGTAATGTTGTTCC	1	1.0	TATGTCATTGCTAGATATAATTGTTAAA	{1132}
3.0169684256646945	3017	3212	195	3017	1	1.0	GTTTTTGTTGAACCTAAGGATGGTGGTCAA	3182	1	1.0	CATGATGTTGAACCTACCCATAAAGTCAAG	1	1.0	TTTTTTGTTTCTGGTGATTATCTTTGGT	{3047}
3.0169684256646945	7830	8025	195	7830	1	1.0	CAAAACAGGGTGCTGGTTTTAAACGTACTT	7995	1	1.0	TTGAAGCACCTTTACACTGTGTTCGTAATG	1	1.0	CTGTGGTATGTATGTTTATTTGTTGTTG	{7868}
3.0169684256646945	12210	12405	195	12210	1	1.0	GGCTGTTAATTCTGGACTTTTAACTGCTTG	12375	1	1.0	CACCAATCAAGATTCTTATGGTGGAGCGTC	1	1.0	GGTCAGGCTATAACAACTAGTGTAGATG	{12343}
3.0169684256646945	25176	25371	195	25176	1	1.0	CAGGCAAGTGTTGGTATCTTGAACAATCAT	25341	1	1.0	TGCGTAAGGTTGACTTGTATAATGGTGCTG	1	1.0	CTATTTATGGTGGTGACCACTATGTCGT	{25227}
3.0193342433258255	9521	9717	196	9521	1	1.0	GGTTCTGTGTTGCGTATTAAGGTTTCACAA	9687	1	1.0	CTTTTATAAATGGAGCTTGTGGTTCTCCTG	1	1.0	TGCATCTGGTGTTTTTGGTGTTAATTTA	{9634}
3.0193342433258255	11894	12090	196	11894	1	1.0	AAAAACCTATGAAAGCTGAGGGTGATGGTG	12060	1	1.0	CTCTCCTTGTCGATTTATGGTCGAAACACC	1	1.0	GTGTTTTAGGTGATGGTAATGCCTTGTA	{11924}
3.0216827288338286	825	1022	197	825	1	1.0	GTAAACCTGTGTTACCTAAAAACATGTGGG	992	1	1.0	CTTGGTACTACAGGTCATACTTTGAAGTCT	1	1.0	GGTGTCACTTATCAATTAGCATGGGATG	{902}
3.024014134296109	22812	23010	198	22812	1	1.0	GGCTTGCAAAACTTACTACAGTTACCTAAC	22980	1	1.0	ACTGCTAATTTATCCATTCCCTCTAACTGG	1	1.0	TTATTATGTTAGTAATGGTGGTAACAAT	{22844}
3.026328706359163	14924	15123	199	14924	1	1.0	GCAGACATTAGTGCTTTTAAAGCCACTTTG	15093	1	1.0	ATCCTAGTAGGATCTTGTCAGCTGGTGTTT	1	1.0	GGTTGAAGAAGATTTAACTAAGGGACCA	{14995}
3.030908310503012	11628	11829	201	11628	1	1.0	GTCAGTTATACCTGCAACTTCAGCTTCCAA	11799	1	1.0	GGAAAATGTTGAAACTTTGACATGGCCTCT	1	1.0	TTCTAAGATTGTTTGTGATGGTTCTGTT	{11691}
3.030908310503012	20454	20655	201	20454	1	1.0	CCTTTTATAGCTGGTAACACTGTTCATGCT	20625	1	1.0	TTGATTAAGAGTGGTAGGTTGTTGTTACGC	1	1.0	TGTCTTTGTCATATAATTCAGTTTTAGA	{20515}
3.0331738099539405	11150	11352	202	11150	1	1.0	TTTGTGATGACCCTGAAAAAGCTCAAGGTA	11322	1	1.0	TGAAAATGCTAGACAAGCTTATGAGGATGC	1	1.0	TGTTGTTAGCACTCCTTGCGTTCTTTCT	{11180}
3.0331738099539405	11210	11412	202	11210	1	1.0	GTAAACATAGTGATTTTGGTCTTGATGGCC	11382	1	1.0	TAAACAATTGAAGCGTGCCATGAATATCGC	1	1.0	GAGGATGCTATTGCTAATGGATCTTCTT	{11344}
3.0331738099539405	19810	20012	202	19810	1	1.0	AATGGAAGTGTGGTTATGCTATGCCACAAA	19982	1	1.0	ACCTCATAATATGCGTGTTTTGCACTATGG	1	1.0	TTTATAAGCTTCAGCGTATGTGTTTGGA	{19840}
3.0331738099539405	23704	23906	202	23704	1	1.0	CAGAGGCTATACATACTGTTACTATTGCAC	23876	1	1.0	AGTTGACAGATTAATTACTGGACGGCTTGC	1	1.0	GGATGTTGTTAATCAACAGGGTAGTGCT	{23747}
3.0331738099539405	25842	26044	202	25842	1	1.0	GGCCACTTGTTCTAGCTTTGTCTATTTTTG	26014	1	1.0	TCCTGAAACTAATGCAATCATCTCTCTCCA	1	1.0	TTTGTCAATTTTAATGTGGACTGGGTCT	{25877}
3.0331738099539405	26568	26770	202	26568	1	1.0	CAACGTGTTGATTTGCCTCCTAAAGTTCAT	26740	1	1.0	CAAAGTTCTCTATTGCTTTGCCTCCAGAGC	1	1.0	CATAAGGACCTTAAATTCAGACAACGTT	{26622}
3.035423411032158	26018	26221	203	26018	1	1.0	GAAACTAATGCAATCATCTCTCTCCAGGTT	26191	1	1.0	TACACCTAGTACCACAATTGTTTGTGACCG	1	1.0	TACGGACATAATTATTACTTACCGGTGA	{26048}
3.0376573353204814	779	983	204	779	1	1.0	GCAGGAAGTGTGGTTTTTGTGGATAAGTAT	953	1	1.0	GAACAGCAAAATGTTTTAGCCATTGAGAGC	1	1.0	TTGATGGTAAACCTGTGTTACCTAAAAA	{819}
3.0376573353204814	3594	3798	204	3594	1	1.0	GAGATGAATTGGGTGTTCGTGTTTTAGATC	3768	1	1.0	TTAGTGGTTCACTTGGTGATAGTGGTAAAC	1	1.0	TTGTTGGATTAGTACCACACTTGTACAG	{3637}
3.04207901698314	15985	16191	206	15985	1	1.0	CCAAATAGGTGAGTTCATCTTTGAGAAGGT	16161	1	1.0	AATTGCACCCTGCTTTTAATGTCAGTGATG	1	1.0	TGATACTGTTACGTATAAGTCTACTGTA	{16027}
3.04426719502264	12086	12293	207	12086	1	1.0	CACCTAATGGTCCTCAAGTGAAGTATTTGT	12263	1	1.0	CTACTTACTTGGAAGCTGTTAAACATGGTG	1	1.0	GAATTGGCTGTTAATTCTGGACTTTTAA	{12205}
3.04426719502264	23564	23771	207	23564	1	1.0	GCAAGCACGACTTAACTATGTTGCTTTACA	23741	1	1.0	GATTCAGGATGTTGTTAATCAACAGGGTAG	1	1.0	AAGGCTATTAATAACATTGTTGCTTCTT	{23643}
3.0464405378427526	11725	11933	208	11725	1	1.0	GCTGGAGTTGTTTGGACACTTAATGATGTT	11903	1	1.0	TGAAAGCTGAGGGTGATGGTGGTGTTTTAG	1	1.0	TTACAAAGGAAAATGTTGAAACTTTGAC	{11792}
3.0464405378427526	15806	16014	208	15806	1	1.0	GCGGCTGAAACTATTAAAGCTAAAGAAGAG	15984	1	1.0	TCCAAATAGGTGAGTTCATCTTTGAGAAGG	1	1.0	TAAAGAGGTTGTGGGACCTAAAGAATTG	{15868}
3.0464405378427526	25236	25444	208	25236	1	1.0	GTGGTGACCACTATGTCGTTTTAGGTGGTG	25414	1	1.0	CTCTTCTCAACTATACGAAGATGTTCCTTC	1	1.0	CTATTAGAGGTTCTTGTGAAAAGAACCT	{25305}
3.048599245246692	597	806	209	597	1	1.0	GCTTACAGGATTGTGTAACCGGTATTAATG	776	1	1.0	GGTGCAGGAAGTGTGGTTTTTGTGGATAAG	1	1.0	ATGATGATTATGTCATTGCATTGACTGG	{627}
3.048599245246692	27360	27569	209	27360	1	1.0	CCCAGTTCTATCAAAGAAATGCAGTCACAA	27539	1	1.0	GTTGCAACCCCATGCGTTTAGCGCATGATA	1	1.0	CTCATGCTGTTCAGAACACAGTACTTAA	{27394}
3.0507435130281846	25638	25848	210	25638	1	1.0	CCTGTTCCAGCTGAAGTACTAAATGTCTAA	25818	1	1.0	AGATGTCTGTTTTATGGTGTTTATGGCCAC	1	1.0	TAAACGATGTCTAATAGTAGTGTGCCTC	{25670}
3.0528735330780323	7997	8208	211	7997	1	1.0	GAAGCACCTTTACACTGTGTTCGTAATGTT	8178	1	1.0	TTACATTACAGGCTGCTTTTGGAAACACAG	1	1.0	CCTATAGTTGTTGGTGTTTCAGAGCGTG	{8093}
3.0549894934871644	920	1132	212	920	1	1.0	GCATGGGATGTTATACGTAAAGACCTTTCT	1102	1	1.0	GGCGTTTGGTTCACCATTTATTACAAATGG	1	1.0	GAGCATTCATTACCTTGGTACTACAGGT	{979}
3.0549894934871644	18620	18832	212	18620	1	1.0	GGTGGTGCTGTTTGTTCAAAACATGCAAAT	18802	1	1.0	AAAAGGGTGTTTTACTGGTGTTGATGGTGA	1	1.0	AATATTTGGGTACCACATAGTTTTGATG	{18701}
3.057091578646307	15547	15760	213	15547	1	1.0	GTATGTATGTAATGCATCAGGTTGTGGTGT	15730	1	1.0	GCTTGCAACGTCTGATTGGACTGATGTTAG	1	1.0	GTGATGTAAAAAAATTGTATCTTGGTGG	{15579}
3.059179969342407	12534	12748	214	12534	1	1.0	GTGTAATGTTTGTGGTTGTTGGTTGGGACA	12718	1	1.0	TCTTGGGTAAGTGTTTGAAGATGAACTGTG	1	1.0	GGTGTGCTTGTGACCGTACAACTATTCA	{12566}
3.0612548428519353	11025	11240	215	11025	1	1.0	CCAATCCAAACTGACTGATTTGAAGTGTAC	11210	1	1.0	GTAAACATAGTGATTTTGGTCTTGATGGCC	1	1.0	GACCCTGAAAAAGCTCAAGGTATGTTGT	{11158}
3.0612548428519353	23152	23367	215	23152	1	1.0	CCTTACGACTTAGTGCTCATTTGGAAACTA	23337	1	1.0	AGCAAAGTTGTTACATCTGGTTTGGGTACT	1	1.0	ATGTTAGTAGTATGCTAACTTTCGATAG	{23185}
3.0633163730311916	3452	3668	216	3452	1	1.0	GTTGTTGAAGCGAGCACTGATTTTCATCAA	3638	1	1.0	TGTTGGATTAGTACCACACTTGTACAGTTG	1	1.0	AAGAGGTTGATATAATTGAACAACCTTT	{3513}
3.0633163730311916	23773	23989	216	23773	1	1.0	CTCTTAACCATCTCACTTCACAATTGAGAC	23959	1	1.0	GTTCCAGACGCTTAGCACAGCAGAAGATTA	1	1.0	TAATTCAATTCAAGCTATTTATGACCGG	{23822}
