cost	target-start	target-end	target-length	left-primer-start	left-primer-num-primers	left-primer-frac-bound	left-primer-target-sequences	right-primer-start	right-primer-num-primers	right-primer-frac-bound	right-primer-target-sequences	num-guides	total-frac-bound-by-guides	guide-target-sequences	guide-target-sequence-positions
2.979211090344213	12293	12473	180	12293	1	1.0	TTCTGGTAGTGGTCAGGCTATTACTAGTAC	12443	1	1.0	AGTGCCTATAGGTACAAATGACCCTATAAG	1	1.0	TTTTGTCAGTATAAAGGCAAGTGGGTAC	{12414}
3.1509757998013184	12443	12648	205	12443	1	1.0	AGTGCCTATAGGTACAAATGACCCTATAAG	12618	1	1.0	ATGGTACAGACATAGATTATTGTGTCCGTG	2	1.0	ACATGTGACCGGACTGCTATCCAAAGTT TTTTGTCTTGAAAATACTGTTTGCAGAG	{12531} {12474}
3.2320643733214482	12380	12473	93	12380	2	1.0	CAGAGCACATGTTGCACATCCAACCATGGA CAGGGCACATGTGGCACACCCAACTATGGA	12443	1	1.0	AGTGCCTATAGGTACAAATGACCCTATAAG	1	1.0	TTTTGTCAGTATAAAGGCAAGTGGGTAC	{12414}
3.234229642842771	15799	16047	248	15799	1	1.0	GGAGATTGTAGGTCCTAAGGAACTTTTGCT	16017	1	1.0	TGACTTCTCATAATGTTGCTCCACTTAGAG	2	1.0	GAAAGTAGATTATGGTTCTGATACGGTG GAAAGTGGATTATGGCTCTGACACGGTG	{15937} {15937}
3.3017433771173463	26691	26780	89	26691	1	1.0	TTTCCGACGTGCTCGAACTTTTTGGGCATG	26750	2	1.0	CAACCGTGCTGGGACAGACGTACTACCAAC CAACCGTGTTGGGACAGACATACTATCAAC	2	1.0	AACCCGGAAGTGAATGCAATCACAGTCA GAATCCTGAGGTTAATGCAATCACTGTC	{26722} {26721}
3.4204729313414406	7586	7688	102	7586	2	1.0	GCGCGCTGGTGCTAAGACTGTTAATGCTAA GCGTGCAGGTGCTAAGGTTGTTAATGCCAA	7658	1	1.0	GGATTTTAACAGTCTTTCTGCTGAAGGTCG	2	1.0	GACAAAAGACCAAACACCTATTGTCTGG GACAAAGGATCAAACTCCTATTGTTTGG	{7622} {7622}
3.5743786676602407	12278	12386	108	12278	1	1.0	GATGTTGACTAATGGTTCTGGTAGTGGTCA	12356	2	1.0	AGGTGCATCTGTTTGTATTTACTGCAGGGC TGGCGCTTCTGTTTGTATTTATTGCAGAGC	3	1.0	ACTCTAATACAACACAGGATACATATGG GGCTATTACTAGTACCATTGATTCTAAC GGCTATTACTAGTACTATTGACTCTAAT	{12328} {12308} {12308}
3.634948055426138	12506	12648	142	12506	2	1.0	TGGTTGCTGGCTCAATCATGGTTGTACTTG TGGTTGTTGGCTTAATCATGGCTGTACATG	12618	1	1.0	ATGGTACAGACATAGATTATTGTGTCCGTG	2	1.0	CGACCGGACTGCTATCCAAAGTTTTGAT TGACCGGACTGCTATTCAAAGTTTTGAT	{12536} {12536}
3.653922044777587	12443	12590	147	12443	1	1.0	AGTGCCTATAGGTACAAATGACCCTATAAG	12560	2	1.0	TGATAACAGTTATTTAAACGAGTCAGGGGC TGATAGCAGTTATTTAAACGAGTCCGGGGC	2	1.0	ACATGTGACCGGACTGCTATCCAAAGTT TTTTGTCTTGAAAATACTGTTTGCAGAG	{12531} {12474}
3.6888006335339796	5746	5903	157	5746	2	1.0	AACGTGACGGTGTGCAAGTTGGTTACTGTG AACGTGATGGTGTGCAAGTTGGTTATTGTG	5873	1	1.0	TTTGAGTGGTGTTGCTTACACTGCTTTTTC	2	1.0	ACCATGGTGTTAAGTATTACTCACGAGT CCCATGGTATTAAGTACTATTCACGTGT	{5776} {5776}
3.7594468288076466	16938	17169	231	16938	2	1.0	ATTCTGCTCAAGGCAGTGAATATGACTATG ATTCTGCTCAAGGTAGCGAGTATGACTATG	17139	1	1.0	GTGGTTTGTTTAAAGATTGTGCACGTAACC	1	1.0	TTATATTCGCACAGACATCAGATACTGC	{16968}
3.770501953228442	12293	12530	237	12293	1	1.0	TTCTGGTAGTGGTCAGGCTATTACTAGTAC	12500	2	1.0	AGTCTGTGGTTGCTGGCTCAATCATGGTTG AGTTTGTGGTTGTTGGCTTAATCATGGCTG	1	1.0	TTTTGTCAGTATAAAGGCAAGTGGGTAC	{12414}
3.7758897580044537	12233	12473	240	12233	2	1.0	TGATGCTGTTAAACAAGGCGCAAAACCTGT TGATGCTGTTAGACAAGGTGCAAAACCCGT	12443	1	1.0	AGTGCCTATAGGTACAAATGACCCTATAAG	1	1.0	TTTTGTCAGTATAAAGGCAAGTGGGTAC	{12414}
3.813223411032158	11245	11448	203	11245	2	1.0	CATCATCTTTTGTTGGTATGCCGTCTTTCA CATCGTCTTTTGTTGGTATGCCATCTTTTG	11418	1	1.0	AGAATGGCTGAACAAGCTGCTGCAGCTATG	2	1.0	GACAGGAGTATGAAAACGCAGTTGCAAA GAGTATGAAAATGCTGTTGCAAATGGTT	{11293} {11298}
3.8390548428519353	15832	16047	215	15832	2	1.0	ATGGGAAAGTGGAAAAGCCAAACCACCGTT ATGGGAAAGTGGAAAAGCCAAACCGCCATT	16017	1	1.0	TGACTTCTCATAATGTTGCTCCACTTAGAG	2	1.0	GAAAGTAGATTATGGTTCTGATACGGTG GAAAGTGGATTATGGCTCTGACACGGTG	{15937} {15937}
3.8889	16938	17030	92	16938	2	1.0	ATTCTGCTCAAGGCAGTGAATATGACTATG ATTCTGCTCAAGGTAGCGAGTATGACTATG	17000	2	1.0	GCTTGTAATGCCAACCGTTTTAACGTAGCT GCTTGTAATGCCAATCGTTTTAACGTTGCC	1	1.0	TTATATTCGCACAGACATCAGATACTGC	{16968}
3.9571942636811994	12506	12594	88	12506	2	1.0	TGGTTGCTGGCTCAATCATGGTTGTACTTG TGGTTGTTGGCTTAATCATGGCTGTACATG	12564	2	1.0	AACAGTTATTTAAACGAGTCAGGGGCTCTA AGCAGTTATTTAAACGAGTCCGGGGCTCTA	2	1.0	CGACCGGACTGCTATCCAAAGTTTTGAT TGACCGGACTGCTATTCAAAGTTTTGAT	{12536} {12536}
3.9604324226839718	12440	12540	100	12440	2	1.0	ACAAGTGCCTATAGGTACAAATGACCCTAT CCAAGTGCCTATAGGTACGAATGACCCTAT	12510	2	1.0	TGCTGGCTCAATCATGGTTGTACTTGTGAC TGTTGGCTTAATCATGGCTGTACATGTGAC	1	1.0	AAGATTTTGTCTTGAAAATACTGTTTGT	{12470}
4.117972960526724	13812	14057	245	13812	1	1.0	CTCAAGGGTTTTTCGATGAAGGTTCAGAAT	14027	2	1.0	AACCTTAATAAAAGCGCTGGTTGGCCCCTT AACCTTAATAAGAGTGCTGGTTGGCCACTT	4	1.0	AAGCTCGTGTAGCTTACCAAGTTGCTTC AGACCTACTATGCTGGATATTGGACAGG ATGTTAGATATAGGACAAGCACGTGTAG TGTATTACATCTAGAGAGGTGGTTGTTA	{13941} {13916} {13925} {13997}
4.125785018119718	16903	17030	127	16903	2	1.0	TGCTAGACTTTTGGGTTTGCAAACTCAAAC TGCTAGGCTTTTAGGTTTACAAACTCAGAC	17000	2	1.0	GCTTGTAATGCCAACCGTTTTAACGTAGCT GCTTGTAATGCCAATCGTTTTAACGTTGCC	1	1.0	TTATATTCGCACAGACATCAGATACTGC	{16968}
4.167736002980723	26751	26865	114	26751	2	1.0	AACCGTGCTGGGACAGACGTACTACCAACC AACCGTGTTGGGACAGACATACTATCAACC	26835	2	1.0	CGTGGACGGACATAGATTGGCTTCAGGTGT CGTGGACGGCCATAGAATCGCTTCAGGTAT	2	1.0	CAGGGATCACAGTAACCCTGTTGAGCGG CGGTGACCTTGTTGAGCGGCGTGCTTTA	{26798} {26807}
4.196123285568201	11423	11542	119	11423	1	1.0	GGCTGAACAAGCTGCTGCAGCTATGTATAA	11512	3	1.0	TTGGCATGCTCCGACGATTGGACATGTCTA TTGGCATGCTCCGTAGGTTGGACATGTCTA TTGGCATGCTCCGTCGTTTGGACATGTCTA	2	1.0	GTTGTTAGTGCAATGCATAGTTTACTCT TGCAGTTAATAGAAAATCAAAGGTTGTT	{11484} {11462}
4.247688527362399	12380	12538	158	12380	2	1.0	CAGAGCACATGTTGCACATCCAACCATGGA CAGGGCACATGTGGCACACCCAACTATGGA	12508	2	1.0	GTTGCTGGCTCAATCATGGTTGTACTTGTG GTTGTTGGCTTAATCATGGCTGTACATGTG	1	1.0	TTTTGTCAGTATAAAGGCAAGTGGGTAC	{12414}
4.259957335320482	19659	19755	96	19659	2	1.0	AACCATGGAGATGGATGCTATGGTGTAAAG AACCATGGCGATGGATGCTTTGGTGTAAAG	19725	2	1.0	GTGCAGAATGGAAATGCGGATATTCTATGC GTGCAGAATGGAAATGTGGTTACTCTATGC	4	1.0	AATGCCGTTGCTACATTCTATCCTCAGT CAATGCTGTTGCCACTTTTTACCCTCAA TGCCGTTGCTACATTCTACCCGCAATTG TTCTGTTGCCACATTCTATCCTCAATTG	{19691} {19690} {19693} {19693}
4.281479969342407	17964	18101	137	17964	2	1.0	CCGTCTATGACTGTTTTGTTAAGAATGTGG CTGTGTATGACTGCTTTGTTAAGAATGTGG	18071	2	1.0	ATGCGCGCTGCTATTAAGTTGTACAATCCT ATGCGTGCTGCTATTAAATTGTACAACCCT	2	1.0	ATTGGTCAATTACCTATCCTATGATAGC CCTACGATAGCTAATGAAAATGCCATAA	{17994} {18011}
4.289700082244952	11309	11448	139	11309	3	1.0	CGCAGTTGCAAATGGATCGTCACCGCAAAT TGCTGTTGCAAATAGTTCCTCACCACAAAT TGCTGTTGCAAATGGTTCTTCACCACAAAT	11418	1	1.0	AGAATGGCTGAACAAGCTGCTGCAGCTATG	2	1.0	AAGCTGAGTTTGACAGGGAGTCATCTGT TGCTAAAGCCGAATTTGACAGGGAGTCA	{11374} {11369}
4.323122420167964	26894	27016	122	26894	3	1.0	CAGTTGCCGTGCCGAGCACTACTATAATTT CAGTTGCCGTGCCTAGTACTACTATAATTT CGGTTGCCGTGCCGAGCACTACTATTATTT	26986	1	1.0	GTAAAACACGGTGACTTTTCTGCAGTGAGC	3	1.0	AGTAGAGTCGGAAGGTCCGTAAATTCTC GTAGAGTCGGAAGGTCCGTAAATTCACG GTAGGGTCGGGAGGTCTGTCAATTCACG	{26926} {26927} {26927}
4.338270128054923	9360	9485	125	9360	2	1.0	CCACGGCACGTTATCGCATCTAATACAACT CCACGTCATGTTATTGCATCTAACACAACT	9455	2	1.0	CTCTGTGTTCCTTGGCGTTGTAGGTGCTAC TACAGCATTTCTTGGTGTTGTAGGTGCTAC	3	1.0	GTTTGCATAATTTTTCTATAACTTCTGG TATAGACTATGAGCACGAATATAGTGTT TGCGGTTGCATAATTTCTCTATAATATC	{9427} {9395} {9424}
4.358788527362399	5881	6039	158	5881	1	1.0	GTGTTGCTTACACTGCTTTTTCTGGACCTG	6009	3	1.0	TCAGTTGTTATGGTAGGGGGTTATGTGGCT TCAGTTGTTATGGTGGGAGGCTATGTCGCA TCAGTTGTTATGGTTGGTGGTTATGTTGCA	2	1.0	GTGACCGTTTTGTTAAACATGACCTTTC TATACTGTTTATGATGCTGCTAAAAAGT	{5965} {5925}
4.3778377053709505	25275	25439	164	25275	2	1.0	CAAGTGGCCGTGGTGGGTGTGGTTGTGCAT TAAGTGGCCATGGTGGGTGTGGTTGTGTAT	25409	2	1.0	GCGAATCAACTAAACTTCCTTATTACGACG GTGAGTCAACTAAACTTCCTTATTACGACG	2	1.0	GTCGTGCTCATCTTTGTGGTGAGTATGT TGTGGCTGTTGTAGTTGTTTATCGTCGT	{25309} {25366}
4.392890556965432	16626	16795	169	16626	1	1.0	GTGCTATAGGACCTGATGTCTTTTTACACA	16765	3	1.0	ACGCGGTAGTGTTCAGGTAGACAATGGCTC ACGTGGTAGTGTACAGGTGGACAATGGTTC ACGTGGTAGTGTGCAGGTAGATAATGGTTC	2	1.0	AAAACAAGTTTGTACCAGTCAAAGATGC AAACAAGTTTGTACCTGTCAAAGAAGCT	{16710} {16711}
4.4008000822449524	12380	12598	218	12380	2	1.0	CAGAGCACATGTTGCACATCCAACCATGGA CAGGGCACATGTGGCACACCCAACTATGGA	12568	2	1.0	GTTATTTAAACGAGTCAGGGGCTCTAGTGC GTTATTTAAACGAGTCCGGGGTTCTAGTGC	1	1.0	TTTTGTCAGTATAAAGGCAAGTGGGTAC	{12414}
4.408814670640964	7658	7799	141	7658	1	1.0	GGATTTTAACAGTCTTTCTGCTGAAGGTCG	7769	3	1.0	ACCTGCAACCAGCATTGTTGCTAAACAAGG ACCTGCAACTAGCATTGTTGCTAAGCAAGG ACCTGCTACTAGCATCTTATCTAAACAAGG	3	1.0	ACTTTCTTGTTAACACTTAATGAAAATC CTAAGGGCTTGACTTTCTTGTTGACAAT GTGGTTAAAACTAGCAAAGCTAAGGGTT	{7725} {7714} {7695}
4.428016028494807	12278	12424	146	12278	1	1.0	GATGTTGACTAATGGTTCTGGTAGTGGTCA	12394	3	1.0	CACATCCAACCATGGACGGGTTCTGTCAGT CACATCCAACCATGGATGGTTTTTGTCAGT CACATCCAACTATGGACGGTTTTTGTCAGT	3	1.0	ACTCTAATACAACACAGGATACATATGG GGCTATTACTAGTACCATTGATTCTAAC GGCTATTACTAGTACTATTGACTCTAAT	{12328} {12308} {12308}
4.456529642842772	12380	12628	248	12380	2	1.0	CAGAGCACATGTTGCACATCCAACCATGGA CAGGGCACATGTGGCACACCCAACTATGGA	12598	2	1.0	CGCTCGACTAGAACCCTGTAATGGTACAGA CGCTCGACTAGAGCCCTGCAATGGTACAGA	1	1.0	TTTTGTCAGTATAAAGGCAAGTGGGTAC	{12414}
4.459085018119716	17410	17604	194	17410	2	1.0	CGTTGTTGGTGACAACGTTGGCACTAATGT TGTCACAGGTGATAATGTTGGCACTAATGT	17574	2	1.0	TACCTCTGTTACGCAAGGGACAACCTTGGA TACCTCTGTTGCGTAAGGGCCAGCCGTGGA	2	1.0	GGTTGTGTTATAACAAACACGGGCAGTG GGTTGTGTTTTAACAAACACTGGCAGTG	{17492} {17492}
4.469888527362399	12147	12305	158	12147	3	1.0	CAAGCTGGCAAACAGACTGAGTTCGTTTCA CAAGCTGGTAAACAGACTGAGTTTGTTTCA CAGGCTGGTAAACAAACTGAGTTTGTTTCA	12275	1	1.0	AAAGATGTTGACTAATGGTTCTGGTAGTGG	3	1.0	TAACGCATTGTTCATTCGCTGTTGACCC TCCCATTTATTAACACATTGTGCTTTTG TGTTCATTTGCAGTCGATCCTGCTGCAG	{12190} {12180} {12198}
4.479923411032158	15799	16002	203	15799	1	1.0	GGAGATTGTAGGTCCTAAGGAACTTTTGCT	15972	3	1.0	AATCCACTGCCACTACAAAATTAGTACCAG AATCCACTGCCACTACTAAGTTAGTACCAG AGTCCACGGCCACTACTAAGTTAGTACCTG	2	1.0	GAAAGTAGATTATGGTTCTGATACGGTG GAAAGTGGATTATGGCTCTGACACGGTG	{15937} {15937}
4.5127942636812	240	328	88	240	2	1.0	CGGGTTTGTGTGGAAGCAAAGTTTCGTCTT CGTGTTTGTGTGGAAGCAAAGTTCTGTCTT	298	3	1.0	CCTGCAACCGTGTGACACTTGCCGTAGCAA CCTGCAACCGTGTGACACTTGCTGTTGCAA CCTGCAACCGTTTTACACTTGCCGTTGCAA	1	1.0	TGTGGAAACCAGTAACTGTTCCTAATGG	{270}
4.523943377117347	9214	9390	176	9214	2	1.0	CACCAACAGTTAGTTATGGTTCGACCTTGC CTCCAACTGTCAGTTATGGTTCTACATTAC	9360	2	1.0	CCACGGCACGTTATCGCATCTAATACAACT CCACGTCATGTTATTGCATCTAACACAACT	3	1.0	CTATGGAAACACTGTGTTGAATGGGTTG TCGTGTTTGTTATGGAAACACTGTGTTG TGTTATGGCAACACTGTGTTAAATGGTT	{9308} {9299} {9306}
4.540109836406473	13099	13281	182	13099	3	1.0	ATGTGTTGCGCTTTGTGACGAAATGGTTCG GTGTGTTGCTCTTTGCGACGAAATGGTGCT GTGTGTTGCTTTTTGCGATGAAATGGTGCT	13251	1	1.0	CTTATATGATGCCTGTTATGGGTATGACCA	3	1.0	AGAGGAGTTGTTGGTGTTTTGACCTTAG TCTATGACTTTGGGGATTTCGTTTTGTG TTATGATTTTGGAGACCTTGTTATGTGT	{13130} {13182} {13183}
4.5556	171	263	92	171	4	1.0	CCTAGTCTAAGGATCTCGTGTTCTGTCACG CCTAGTCTAAGGGTTCCGTGTTCCGTCACG CCTAGTCTAAGGGTTCTGTGTTCTGTCACG TCTAGTCTAAGGGTTTCGTGTTCCGTCACG	233	1	1.0	TCTGTCTCGTGTTTGTGTGGAAGCAAAGTT	1	1.0	TCCATTCTACAAACGCCTTACTCGAGGT	{205}
4.55723196905215	13039	13281	242	13039	3	1.0	TGAGGACATACACCGCGTGTACGCTGCTTT TGAGGACATACACCGTGTATACGCTGCTTT TGAGGACATACACCGTGTGTATGCTGCTTT	13251	1	1.0	CTTATATGATGCCTGTTATGGGTATGACCA	2	1.0	GGCAAAGTAGTCGCAAATGCAATGATTA GTGTTGCTCTTTGCGACGAAATGGTGCT	{13070} {13101}
4.5624729605267245	9769	10014	245	9769	1	1.0	GCTTTGATGGTGTTATGTATGGTGGTTTTG	9984	3	1.0	TTCTCCATTCTTGCTGCTAAAACTGGCGTT TTTTCCATTCTTGCTGCTAAAACTGGTGTC TTTTCTATTCTTGCTGCAAAAACCGGTGTC	2	1.0	AACCTTCAAGTTGAATCTGCAAACCAGA ACTATAATGAATGGGCACAGTCCAATGG	{9810} {9928}
4.584226686365172	14389	14589	200	14389	2	1.0	GGACTATCCCAAGTGTGATAGGGCTATGCC GGACTATCCTAAGTGTGATAGAGCTATGCC	14559	2	1.0	ATTTTAAACCCGGTGGTACAACTTCAGGTG ATTTTAAACCTGGTGGTACAACTTCTGGTG	3	1.0	CAATGATTCGTATGCTGTCGGCCATGAT CGGCTAGTGACAAGTTTTATAGACTTAG TCAATGATTCGAATGTTGTCAGCTATGA	{14421} {14478} {14420}
4.678829642842771	26845	26952	107	26845	2	1.0	CATAGAATCGCTTCAGGTATTCAGGTTCAT CATAGATTGGCTTCAGGTGTTCAGGTTCAT	26922	3	1.0	TTATAGTAGAGTCGGAAGGTCCGTAAATTC TTATAGTAGGGTCGGAAGGTCCGTAAATTC TTATAGTAGGGTCGGGAGGTCTGTCAATTC	1	1.0	CTGAACACATGACAGTTGCCGTGCCGAG	{26882}
4.734100082244952	15610	15828	218	15610	3	1.0	GTACAAAAGTTCTGCGCTGGGTTCCATAGA GTACAAAAGTTCTGCTGTGGGTTCCGTAGA GTACAAAAGTTCTGCTTTGGGTTCCATAGA	15798	1	1.0	AGGAGATTGTAGGTCCTAAGGAACTTTTGC	4	1.0	AATAAGCTTTCTACTTCTGATTGGTCTG GCTAATGATGCAAAAGAGTCACTAAGGT GTAGATGTTTTTAATAAGCTCTCCACAT TGGCTAATGAAGCTAAGGAGTCACTAAG	{15653} {15701} {15641} {15699}
4.7349942636812	12596	12712	116	12596	2	1.0	GCCGCTCGACTAGAACCCTGTAATGGTACA GCCGCTCGACTAGAGCCCTGCAATGGTACA	12682	3	1.0	CGGAAAAAATCTGAAGTCCAATTGTGTGCG CGGCAAAAACTTGAAGTCCAATTGTGTGCG CGGCAAGAATTTGAAGTCCAATTGTGTGCG	1	1.0	GACATAGATTACTGTGTCCGTGTATTTG	{12626}
4.787664373321449	11244	11337	93	11244	2	1.0	GCATCATCTTTTGTTGGTATGCCGTCTTTC GCATCGTCTTTTGTTGGTATGCCATCTTTT	11307	3	1.0	AACGCAGTTGCAAATGGATCGTCACCGCAA AATGCTGTTGCAAATAGTTCCTCACCACAA AATGCTGTTGCAAATGGTTCTTCACCACAA	3	1.0	ATATGAAACTGCACGACAGGAGTATGAA GTGGCCTACGAAACGGCAAGACAGGAGT GTTGCATATGAAACAGCAAGACAAGAGT	{11279} {11274} {11274}
4.846094263681199	17140	17256	116	17140	1	1.0	TGGTTTGTTTAAAGATTGTGCACGTAACCC	17226	4	1.0	AAACTAGTGGCGATTTGGCTGTCCAAATAG AGACTAGTGGTGACTTAGCTGTCCAGATAG AGACTAGTGGTGACTTGGCTGTTCAAATAG AGACTAGTGGTGATTTAGCTGTTCAGATAG	2	1.0	ACTACTTATCTATCATTGTCTGATAGAT TTTGCCACCTAGCCATGCCACTACGTAT	{17195} {17176}
4.857343377117346	26592	26710	118	26592	4	1.0	AAACTGGGGATCCAACTGGGCCTTTGTCGC AAATTGGGGAACCAATTGGGCCTTTGTTGC TAACTGGAATGAGAACTGGGCCTTTGTTGC TAATTGGGACTCTAATTGGGCCTTTGTTGC	26680	1	1.0	AGTTTCAGACTTTTCCGACGTGCTCGAACT	2	1.0	ATTAAGCCTTTTTATGGCCATAGCCACA GCCGTATCAACACTCATTATGTGGGTGA	{26622} {26638}
4.864972931341441	12910	13054	144	12910	3	1.0	GGACTTGTGCTTTGCTCTGCGTAACTTTGA GGATTTGTGCTTCGCTCTGCGTAACTTTGA GGATTTGTGTTTTGCCCTGCGTAATTTTGA	13024	2	1.0	TGACCCAGTAGAAAATGAGGACATACACCG TGACCCCATAGAAAATGAGGACATACACCG	1	1.0	CTGATTACTTCGAAATGAAGAATTGGTT	{12996}
4.898764373321448	14389	14482	93	14389	2	1.0	GGACTATCCCAAGTGTGATAGGGCTATGCC GGACTATCCTAAGTGTGATAGAGCTATGCC	14452	3	1.0	AGGTTCAAAGCACGTCACATGTTGTACGGC AGGTTCTAAACATGTTACATGTTGTACGGC AGGTTCTAAGCATGTCACATGTTGTACGGC	4	1.0	CAATGATTCGTATGCTGTCGGCCATGAT TCAATGATACGCATGTTGTCAGCTATGA TCAATGATTCGAATGTTGTCAGCTATGA TCAATGATTCGTATGTTATCAGCTATGA	{14421} {14420} {14420} {14420}
4.901029642842771	5796	5903	107	5796	4	1.0	TCACGAGTCAGGAGTGTTAGTGGGCGTGCC TCACGTGTTAAAAGTGTTAGAGGTAGAGCT TCACGTGTTAAGAGTGTCAGTGGTAGAGCC TCACGTGTTAGAAGTGTTAGCGGTAGAGCT	5873	1	1.0	TTTGAGTGGTGTTGCTTACACTGCTTTTTC	3	1.0	ATCATAGTAGGTGTTGAACAAATTGAAC ATCATAGTTAGTGTAGAGCGTCTTGAAC ATTATATTCAGTGTCGAACAGCTTGAAC	{5826} {5826} {5826}
4.903585018119717	16072	16199	127	16072	2	1.0	ATACTCCACCATTTACAAGTTGCATCCATC ATATTCCACCATTTACAAGTTGCACCCATC	16169	3	1.0	ACAACAATACAGGGTCCGCCTGGTAGTGGT ACCACAATACAGGGTCCTCCTGGTAGTGGA ACTACAATACAGGGTCCCCCTGGTAGTGGT	2	1.0	ATATGCAAATCTTGTACCGTATTACCAG TGTTAGTGATGCTTATGCAAACCTTGTA	{16120} {16108}
4.917626686365171	9769	9899	130	9769	1	1.0	GCTTTGATGGTGTTATGTATGGTGGTTTTG	9869	4	1.0	TGCGGCTATATTGAATGGTTGCACCTGGTG TGCTGCCATACTGAATGGTTGTACATGGTG TGCTGCTATATTGAATGGTTGCACATGGTG TGCTGCTATATTGAATGGTTGCATATGGTG	2	1.0	ACCAGATGCTAACAGTTAATGTGGTCGC CCTTCAAGTTGAATCTGCAAACCAGATG	{9832} {9812}
4.92217380995394	13150	13281	131	13150	4	1.0	AACTCTAGACAACCAGGATCTTAATGGGAA GACCCTCGATAATCAGGATCTCAATGGGAA GACCTTAGACAACCAAGATCTTAATGGGAA GACCTTAGATAACCAAGACCTTAATGGGAA	13251	1	1.0	CTTATATGATGCCTGTTATGGGTATGACCA	2	1.0	GTCCTCCTGGAATGGGAATACCCTACTG TCTACGATTTTGGGGACTTTGTTTTGTG	{13209} {13182}
4.933437705370951	12147	12259	112	12147	3	1.0	CAAGCTGGCAAACAGACTGAGTTCGTTTCA CAAGCTGGTAAACAGACTGAGTTTGTTTCA CAGGCTGGTAAACAAACTGAGTTTGTTTCA	12229	2	1.0	ATCTTGATGCTGTTAAACAAGGCGCAAAAC ATCTTGATGCTGTTAGACAAGGTGCAAAAC	3	1.0	TAACGCATTGTTCATTCGCTGTTGACCC TCCCATTTATTAACACATTGTGCTTTTG TGTTCATTTGCAGTCGATCCTGCTGCAG	{12190} {12180} {12198}
4.9571942636812	14044	14160	116	14044	1	1.0	TGGTTGGCCACTTAATAAGTTTGGTAAAGC	14130	4	1.0	CAAAGCGTAACATTCTCCCTACTATGACCC CAAAGCGTAATATCCTTCCTACTATGACTC CAAAGCGTAATATTCTCCCTACTATGACTC CGAAGCGTAACATTCTTCCTACTATGACTC	3	1.0	CTATTAGTTATGAGGAACAAGATGCCAT TCTATTAGCTATGAGGAACAAGACGCAA TTAGTTATGAAGAACAAGACGCTATGTT	{14091} {14090} {14094}
4.960043765448655	26751	26924	173	26751	2	1.0	AACCGTGCTGGGACAGACGTACTACCAACC AACCGTGTTGGGACAGACATACTATCAACC	26894	3	1.0	CAGTTGCCGTGCCGAGCACTACTATAATTT CAGTTGCCGTGCCTAGTACTACTATAATTT CGGTTGCCGTGCCGAGCACTACTATTATTT	1	1.0	GCTTCAGGTGTTCAGGTTCATAACCTAC	{26854}
4.98722672308638	15937	16120	183	15937	2	1.0	GAAAGTAGATTATGGTTCTGATACGGTGAC GAAAGTGGATTATGGCTCTGACACGGTGAC	16090	3	1.0	GTTGCACCCATCATTTAATGTTAGTGATGC GTTGCACCCATCCTTTAATGTTAGCGATGC GTTGCATCCATCCTTTAATGTTAGTGATGC	1	1.0	TTCTCATAATGTTGCTCCACTTAGAGCA	{16021}
4.990985705661207	11167	11271	104	11167	3	1.0	TGTCTAAGCATAGTGATTTTGGACTCGGTG TGTCTAAGCATAGTGATTTTGGTCTTGGCG TGTCTAAGCATAGTGATTTTGGTCTTGGTG	11241	2	1.0	GTCGCATCATCTTTTGTTGGTATGCCGTCT GTTGCATCGTCTTTTGTTGGTATGCCATCT	4	1.0	GTCGATTCCTATTTTGAGAACGATAGTA TTCTTATTTTGAAAACGACGCCATTTTG TTCTTATTTTGAGAATGACTCCATTTTG TTTAGTTGATTCTTATTTTGAGAATGAC	{11202} {11207} {11207} {11198}
4.990985705661207	17023	17171	148	17023	2	1.0	CGTAGCTATTACAAGGGCTAAGAAGGGTAT CGTTGCCATTACTAGAGCAAAGAAAGGCAT	17141	3	1.0	GGTTTGTTCAAAGATTGTGCACGTAACCCT GGTTTGTTTAAAGATTGTGCACGTAACCCC GGTTTGTTTAAGGATTGTGCACGTAACCCT	2	1.0	CTTTTGTATCATGTCAGATAAGAGTTTG TGCACTTAAATTCTTTGAAATCACTATG	{17053} {17086}
5.012129642842771	16773	16927	154	16773	3	1.0	GTGTACAGGTGGACAATGGTTCCAGTATAA GTGTGCAGGTAGATAATGGTTCCAGTATAA GTGTTCAGGTAGACAATGGCTCCAGTATAA	16897	2	1.0	TGTAGCTGCTAGGCTTTTAGGTTTACAAAC TGTCGCTGCTAGACTTTTGGGTTTGCAAAC	2	1.0	CGTCGACAACTTGACGTCGTCAAGCGTT GCGATTTATACATAAAAACCCTACATGG	{16805} {16828}
5.031964845367944	11777	11937	160	11777	3	1.0	TGTCTGGCCTCTGATTTTGACCTGCGAACG TGTTTGGCCTCTGATTTTGACTTGTGAACG TGTTTGGCCTTTGGTTTTGACATGTGAACG	11907	2	1.0	CTATACAACAATGAAGGTGGACGTGCATTT TTATACAATAATGAGGGTGGCCGTGCATTT	2	1.0	ATGGAGGCATTATTAGTGAAGGTAATGC TAATGCCAGGTAAAATGAAGGTCAAAGC	{11878} {11833}
5.035523411032159	26751	26954	203	26751	2	1.0	AACCGTGCTGGGACAGACGTACTACCAACC AACCGTGTTGGGACAGACATACTATCAACC	26924	3	1.0	ATAGTAGAGTCGGAAGGTCCGTAAATTCAC ATAGTAGGGTCGGAAGGTCCGTAAATTCAC ATAGTAGGGTCGGGAGGTCTGTCAATTCAC	1	1.0	GCTTCAGGTGTTCAGGTTCATAACCTAC	{26854}
5.038312910986066	11423	11585	162	11423	1	1.0	GGCTGAACAAGCTGCTGCAGCTATGTATAA	11555	4	1.0	CCTTAATATGGCACGTAATGGTGTTGTCCC TCTCAATATGGCACGTAATGGTGTTGTCCC TCTTAACATGGCACGTAATGGTGTTGTACC TCTTAATATGGCACGTAATGGTGTTGTTCC	2	1.0	GTTGTTAGTGCAATGCATAGTTTACTCT TGCAGTTAATAGAAAATCAAAGGTTGTT	{11484} {11462}
5.0550894934871655	8372	8508	136	8372	3	1.0	GCCAGAAGTTATTGCACAAGGCTTTGGGTT GCCAGAAGTTATTGCACAGGGTTTTGGTTT GCCGGAAATAATTGCACAGGGCTTTGGTTT	8478	2	1.0	GGCTTGGATAAGTGGTTTGTTAATGATGGA GGCTTTGACAAGTGGTTTGTTAATGATGGA	3	1.0	AGAACAGTGCGTACCATCGCTACTAAGT GAACAGTGCGTACTATTGCTACCAAATA GGTGAATGTGTAGACTCCAATGCAGGTG	{8403} {8404} {8442}
5.057191578646307	7586	7799	213	7586	2	1.0	GCGCGCTGGTGCTAAGACTGTTAATGCTAA GCGTGCAGGTGCTAAGGTTGTTAATGCCAA	7769	3	1.0	ACCTGCAACCAGCATTGTTGCTAAACAAGG ACCTGCAACTAGCATTGTTGCTAAGCAAGG ACCTGCTACTAGCATCTTATCTAAACAAGG	1	1.0	GGATTTTAACAGTCTTTCTGCTGAAGGT	{7658}
5.06251812834518	15832	16002	170	15832	2	1.0	ATGGGAAAGTGGAAAAGCCAAACCACCGTT ATGGGAAAGTGGAAAAGCCAAACCGCCATT	15972	3	1.0	AATCCACTGCCACTACAAAATTAGTACCAG AATCCACTGCCACTACTAAGTTAGTACCAG AGTCCACGGCCACTACTAAGTTAGTACCTG	2	1.0	GAAAGTAGATTATGGTTCTGATACGGTG GAAAGTGGATTATGGCTCTGACACGGTG	{15937} {15937}
5.063416373031192	26988	27126	138	26988	1	1.0	AAAACACGGTGACTTTTCTGCAGTGAGCTC	27096	4	1.0	TGGGCTGATGAGTCTGAGCAGCAGCGTGGT TGGGCTGATGCATCTGAACCACAACGTGGT TGGGCTGATGCTTCTGAACCACGGCGTGGT TGGGCTGATTCCTCTGAACCACAACGTGGT	3	1.0	ACGAGCAATATGACAGAAAACGAAAGAT CACAGAGCAATATGACAGAAAATGAAAG CTACGAGCAACATGTCAGAAAATGAAAG	{27022} {27020} {27020}
5.090411090344213	17704	17884	180	17704	2	1.0	CACCATGCGTTATTTTGTAAAGATAGGCTC CACTATGCGTTATTTTGTCAAGATTGGAGC	17854	3	1.0	ACAACAATGGGGTTATGTTGGTTCTCTTTC ACAACAGTGGGGCTATGTTGGTTCACTCTC TCAACAATGGGGTTATGTTGGTTCACTCTC	2	1.0	AAACATTGCCAATGTGGTACTATTGCTA AAACATTGCCAATGTGGTACTGTTGCAA	{17738} {17738}
5.1110657561098884	12639	12880	241	12639	1	1.0	GTGTCCGTGCATTTGACGTTTACAATAAAG	12850	4	1.0	TGAAGGCAGAACCATCTATGGTAACGTTAG TGAAGGCCGAACCATCTATGGTAATGTTAG TGAGGGCAGAACCATCTATGGTAATGTTAG TGAGGGCAGAACCATTTATGGTAATGTTAG	1	1.0	CTTGAAGTCCAATTGTGTGCGCTTCAAG	{12691}
5.1111	17480	17604	124	17480	3	1.0	GCGCAACCTGAAGGTTGTGTTATAACAAAC GCGCAACCTGAGGGTTGTGTTGTAACAAAC GCTCAACCTGAAGGTTGTGTTTTAACAAAC	17574	2	1.0	TACCTCTGTTACGCAAGGGACAACCTTGGA TACCTCTGTTGCGTAAGGGCCAGCCGTGGA	4	1.0	ACAGGCAGTGTTTTGAAACCTGTTCGTG ACGGGCAGTGTTGTAAAACCTGTTCGTG ACGGGCAGTGTTGTAAAACTTGTTCGTG CCTGTTCGTGCTCGTGCACCTCCTGGAG	{17510} {17510} {17510} {17528}
5.118526590941621	6305	6496	191	6305	1	1.0	TAAGTGGTGGCTGCTTGCTAAGTTTATGAA	6466	4	1.0	GCGGTAATTCATTGGGCTGTAAGATGTGTC GTGAAGGTTCACTAGGTTGTAAAATGTGTC GTGATGGTTCATTGGGCTGCAAGATGTGTC GTGATGGTTCATTGGGCTGTAAAATGTGTC	2	1.0	TGATTTTACTTGGTGTACGCTTTGGACC TTAATGGTTATGCTAAGTCAAACTTTGT	{6367} {6424}
5.118526590941621	9056	9247	191	9056	2	1.0	CTCTCCAGAAAAGTTGAAAAGTTATGCTGC TTCGCCAGATAAGTTGAAAAGTTATGCAGC	9217	3	1.0	CAACAGTTAGTTATGGTTCGACCTTGCAAG CAACTGTCAGTTATGGGTCTACATTACAAG CAACTGTCAGTTATGGTTCTACATTACAGG	2	1.0	TATGCTTATTTGGCAAAGGCCATGATGG TTGTTATGCATATCTAGCAAAAGCAATG	{9150} {9146}
5.119801087828205	12808	13054	246	12808	3	1.0	AAACTGCGATGCTGTCGCAAAGCATGATTT AGGCTGTAATGCTATTGCCAAGCATGACTT AGGCTGTAATGCTGTTGCTAAGCATGATTT	13024	2	1.0	TGACCCAGTAGAAAATGAGGACATACACCG TGACCCCATAGAAAATGAGGACATACACCG	1	1.0	CTGATTACTTCGAAATGAAGAATTGGTT	{12996}
5.128168425664694	16773	16968	195	16773	3	1.0	GTGTACAGGTGGACAATGGTTCCAGTATAA GTGTGCAGGTAGATAATGGTTCCAGTATAA GTGTTCAGGTAGACAATGGCTCCAGTATAA	16938	2	1.0	ATTCTGCTCAAGGCAGTGAATATGACTATG ATTCTGCTCAAGGTAGCGAGTATGACTATG	2	1.0	CGTCGACAACTTGACGTCGTCAAGCGTT GCGATTTATACATAAAAACCCTACATGG	{16805} {16828}
5.130534243325825	8876	9072	196	8876	3	1.0	ATGGTGGCTGTGTGCTTGGTACTTTCTTGC ATGGTGGTTGTGTACTTGGTACTTTTTGGC GTGGTGGCTGTGCGCCTGGTACTTTTTATC	9042	2	1.0	CTTGCTAACAGCATTTCGCCAGATAAGTTG CTTGCTAATAGCATCTCTCCAGAAAAGTTG	2	1.0	AATGTTAACAGGTTTGTTACCCAGTTTG TTACCTAGTTTGTTGAAGCTTAAAGTCT	{8906} {8922}
5.132882728833828	25242	25439	197	25242	3	1.0	CCTTGAGTGGCTCAACCGTGTAGAAAACTA CTTAAAGTGGCTCAACCGGGTTGAGACTTA TCTTGAGTGGCTCAACCGTGTTGAGACTTA	25409	2	1.0	GCGAATCAACTAAACTTCCTTATTACGACG GTGAGTCAACTAAACTTCCTTATTACGACG	2	1.0	CGTGGTGGGTGTGGTTGTGCATTTCAGT TGTGGCTGTTGTAGTTGTTTATCGTCGT	{25283} {25366}
5.137528706359164	11498	11697	199	11498	2	1.0	GCATAGTTTACTCTTTGGCATGCTCCGACG GCATCGCTTACTCTTTGGCATGCTCCGTAG	11667	3	1.0	GATGGCTTTGTTCACTACGCAGGTGTTGTT GATGGTTTTGTGCACTACGCTGGCGTTGTT GATGGTTTTGTTCACTACGCGGGTGTTGTT	2	1.0	GATCATGATTCATTTGCGAGAATGATGG GTTGTTGTAGTACCAGATCATGAATCAT	{11637} {11622}
5.15327901698314	9776	9982	206	9776	2	1.0	TGGTGTTATGTATGGCGGTTTTGATGACCA TGGTGTTATGTATGGTGGTTTTGAAGACCA	9952	3	1.0	ATGGTTTCACAGCTATGAATGGTGAAGACG ATGGTTTTACAGCCATGAATGGTGAAGATG ATGGTTTTACAGCTATGAATGGCGAAGATG	2	1.0	ACCAGATGCTAACAGTTAATGTGGTCGC CCTTCAAGTTGAATCTGCAAACCAGATG	{9832} {9812}
5.15327901698314	15367	15500	133	15367	1	1.0	AACAGTTCTAAGATGCGGTGATTGTTTACG	15470	4	1.0	ACACCATATGTGTGTAACACATCTGGTTGC ACACCATATGTTTGTAACACATCTGGCTGC ACACCTTATGTGTGTAACACATCTGGCTGC ACACCTTATGTTTGTAACACATCTGGTTGC	4	1.0	CTTATGATCATGTGTTTGGAACTGATCA CTTATGATCATGTGTTTGGCACGGATCA GTGTTTGGCACTGATCATAGGTTCATTT TGCTTATGATCATGTGTTTGGCACGGAT	{15423} {15423} {15434} {15421}
5.159799245246692	16626	16835	209	16626	1	1.0	GTGCTATAGGACCTGATGTCTTTTTACACA	16805	4	1.0	AGACGCCAACTTGATGTTGTTAAGCGATTT AGGCGCCAACTCGATGTTGTCAAGCGATTT AGGCGTCAACTTGATGTTGTTAAGCGATTT CGTCGACAACTTGACGTCGTCAAGCGTTTT	2	1.0	AAAACAAGTTTGTACCAGTCAAAGATGC AAACAAGTTTGTACCTGTCAAAGAAGCT	{16710} {16711}
5.166189493487164	13024	13236	212	13024	2	1.0	TGACCCAGTAGAAAATGAGGACATACACCG TGACCCCATAGAAAATGAGGACATACACCG	13206	3	1.0	TGTGTCCGCCTGGAATGGGAATACCTTATT TGTGTCCTCCTGGAATGGGAATACCCTACT TGTGTCCTCCTGGTATGGGAATACCCTATT	2	1.0	GTACGCTGCTTTGGGCAAAGTAGTCGCA GTGTTGCTCTTTGCGACGAAATGGTGCT	{13057} {13101}
5.172454842851935	16556	16771	215	16556	2	1.0	GCCCCTAGGGTGCTTATATCCAAAGGAACT GCTCCTAGAGTTCTTATCTCTAAAGGTGTT	16741	3	1.0	TAAGCAGTGCTTCAAAACCTTTGAACGCGG TAAGCAGTGCTTCAAAATCTTTGAACGTGG TAAGCAGTGCTTTAAGATCTTTGAACGTGG	2	1.0	AAAACAAGTTTGTACCAGTCAAAGATGC AAACAAGTTTGTACCTGTCAAAGAAGCT	{16710} {16711}
5.188587395870145	19084	19307	223	19084	2	1.0	CTCTGCTACTGCTGTGAAAGCAGGTGGTAA CTCTGTTACTGCTGTTAAAACAGGTGGTAA	19277	3	1.0	AACCTCCAAGACTTTTTACCGCGTAGCACA AACTTACAAGACTTTTTGCCCCGTAGCACA AATTTACAAGACTTTTTGCCTCGCAGCACA	2	1.0	ATTTGCCAGCCATTCGGTTAAATTTTGG TTGCCGGCTATTAAATTGAATTTTGGAA	{19116} {19118}
5.190548055426138	9166	9390	224	9166	3	1.0	AAGCAATGCTGGATTTTTCGCGTGATCATA AAGCAATGTTGGACTTTTCGCGTGATCATA AGGCCATGATGGACTATTCGCGTGATCATA	9360	2	1.0	CCACGGCACGTTATCGCATCTAATACAACT CCACGTCATGTTATTGCATCTAACACAACT	2	1.0	TACACACCTCCAACTGTCAGTTATGGTT TATACACCACCAACAGTTAGTTATGGTT	{9207} {9207}
5.198272931341441	11907	12135	228	11907	2	1.0	CTATACAACAATGAAGGTGGACGTGCATTT TTATACAATAATGAGGGTGGCCGTGCATTT	12105	3	1.0	AGAGGTGCTGTTTTGGGTTACATTGGTGCC AGAGGTGCTGTTTTGGGTTATATCGGTGCT AGGGGTGCTGTTTTGGGTTACATAGGCGCT	2	1.0	TGTATGCATATGTGACCACAAAACCTGA TTAAATGGGAGCATGACTCTGGTGTGGT	{11938} {11977}
5.201511090344213	13251	13431	180	13251	1	1.0	CTTATATGATGCCTGTTATGGGTATGACCA	13401	4	1.0	AGTATTGGGGACAAGACTATCACCCTGATT AGTATTGGGGACAGGATTATCATCCTGATT AGTATTGGGGACAGGGTTACCATCCTGATT AGTATTGGGGTCAAGATTATCACCCTGATT	3	1.0	AAGGTGGTTTTGTTCAACAAGTATTTTA ATTTCACAGAGCATAAGGAGGTTTTGTT TGATTTCACAGAACATAAGGATGTTTTG	{13373} {13359} {13357}
5.202066666009797	281	511	230	281	1	1.0	GTAACTGTTCCTAATGGCCTGCAACCGTGT	481	4	1.0	TGGGTCTGACCGGCGACCAACCACTGGTTT TGGGTCTGCATGGCAATCAGACGTTGTTTT TGGGTCTGCATGGTAACCAAACGTTGTTCT TGGGTTTGCATGGTAACCAAACGTTGTCCT	2	1.0	CAATGGATTTAGAGCATGCCGATTTGTC CCGTAGCAAGTGATACTGAAATTTCTGC	{401} {319}
5.209522044777587	12147	12381	234	12147	3	1.0	CAAGCTGGCAAACAGACTGAGTTCGTTTCA CAAGCTGGTAAACAGACTGAGTTTGTTTCA CAGGCTGGTAAACAAACTGAGTTTGTTTCA	12351	2	1.0	TATGGAGGTGCATCTGTTTGTATTTACTGC TATGGTGGCGCTTCTGTTTGTATTTATTGC	2	1.0	GGTCAGGCTATTACTAGTACTATTGACT TAACGCATTGTTCATTTGCTGTTGACCC	{12303} {12190}
5.213185705661208	19453	19689	236	19453	3	1.0	AGGTAAGATGGGCATCCTTAAAGCTGAAGA GAGTAAAATGGGCATCTTAAAGGCAGAGGA GAGTAAAATGGGCATCTTGAAGGCAGAAGA	19659	2	1.0	AACCATGGAGATGGATGCTATGGTGTAAAG AACCATGGCGATGGATGCTTTGGTGTAAAG	2	1.0	CTGCTGCGTCTGATGTAACACTTAAGTG GACCTATCTTAATGATCCTAGCTCTAAG	{19488} {19525}
5.220389758004454	11925	12165	240	11925	2	1.0	GGACGTGCATTTATGTATGCATATGTGACT GGCCGTGCATTTATGTATGCGTATGTGACC	12135	3	1.0	ACTGTGAGATTGCAAGCTGGTAAACAGACT ACTGTGAGGTTGCAAGCTGGCAAACAGACT ACTGTTAGACTGCAGGCTGGTAAACAAACT	2	1.0	ATCTTAACAATTTAAGGAGAGGTGCTGT GCCTGACATGAAGTACGTTAAATGGGAA	{12088} {11960}
5.227435466635868	8996	9240	244	8996	3	1.0	TGCTGCAGCTGGTACATTTGTGATTGACAT TGCTGCTGCAGGAACATTTGTTATTGACAT TGCTGCTGCAGGTACGTTTGTTCTAGACAT	9210	2	1.0	ACACCACCAACAGTTAGTTATGGTTCGACC ACACCTCCAACTGTCAGTTATGGTTCTACA	2	1.0	CTTGCTAATAGCATCTCTCCAGAAAAGT GAAAAGCTTGCTAACAGCATTTCGCCAG	{9042} {9036}
5.229172960526724	16556	16801	245	16556	2	1.0	GCCCCTAGGGTGCTTATATCCAAAGGAACT GCTCCTAGAGTTCTTATCTCTAAAGGTGTT	16771	3	1.0	TAGTGTACAGGTGGACAATGGTTCCAGTAT TAGTGTGCAGGTAGATAATGGTTCCAGTAT TAGTGTTCAGGTAGACAATGGCTCCAGTAT	2	1.0	AAAACAAGTTTGTACCAGTCAAAGATGC AAACAAGTTTGTACCTGTCAAAGAAGCT	{16710} {16711}
5.2309010878282045	17855	18101	246	17855	3	1.0	CAACAATGGGGTTATGTTGGTTCACTCTCT CAACAATGGGGTTATGTTGGTTCTCTTTCC CAACAGTGGGGCTATGTTGGTTCACTCTCA	18071	2	1.0	ATGCGCGCTGCTATTAAGTTGTACAATCCT ATGCGTGCTGCTATTAAATTGTACAACCCT	2	1.0	CCTACGATAGCTAATGAAAATGCCATAA TGTGGATTGGTCAATTACCTATCCTATG	{18011} {17989}
5.237721916171137	15610	15860	250	15610	3	1.0	GTACAAAAGTTCTGCGCTGGGTTCCATAGA GTACAAAAGTTCTGCTGTGGGTTCCGTAGA GTACAAAAGTTCTGCTTTGGGTTCCATAGA	15830	2	1.0	TCATGGGAAAGTGGAAAAGCCAAACCACCG TCATGGGAAAGTGGAAAAGCCAAACCGCCA	2	1.0	AAGGAGATTGTAGGTCCTAAGGAACTTT GGAGATTGTAGGCCCTAAGGAACTTTTG	{15797} {15799}
5.2688405378427525	12711	12808	97	12711	5	1.0	GCTTCAAAAATGCAGATAAGGACGATGCGT GCTTCAAAAATGCAGATAAGGATGATGCGT GCTTCAAGAACGCAGATAAGGATGATGCGT GCTTCAAGAATGTAGATAAGGATGACGCGT GCTTCAGAAATGCTGATAAGGATGATGCGT	12778	1	1.0	CCACGAGCAGTCCATGTATAACTTACTTAA	1	1.0	TTAAACGTTGTATTAAGTCAGTTATGGA	{12750}
5.29896788931984	8372	8547	175	8372	3	1.0	GCCAGAAGTTATTGCACAAGGCTTTGGGTT GCCAGAAGTTATTGCACAGGGTTTTGGTTT GCCGGAAATAATTGCACAGGGCTTTGGTTT	8517	2	1.0	AATGGTTATGTTTGCGGTACAGGTCTGTGG AATGGTTATGTTTGTGGTACTGGTTTGTGG	4	1.0	AGAACAGTGCGTACCATCGCTACTAAGT AGGACAATACGCACTGTAGCAACCAAGT CCAATGCAGGTGTGTGTTTTGGCTTTGA GAACAGTGCGTACTATTGCTACCAAATA	{8403} {8403} {8458} {8404}
5.313166666009797	18882	19112	230	18882	3	1.0	CCCTCAGTATTCTCAAAAACCTCGGTGTTG CTCTCAGTATTCTCAAAAACCTTGGTGTTG CTCTTAGCATTCTTAAGAACCTAGGTGTTG	19082	2	1.0	TTCTCTGCTACTGCTGTGAAAGCAGGTGGT TTCTCTGTTACTGCTGTTAAAACAGGTGGT	3	1.0	ATTATGAAGCAGAACGTCCTCTAACTAG ATTATGAAGCTGACCGGCCCTTGACAAG TCTGTTTGTGGTTATACAGACTTTACAG	{18939} {18939} {18977}
5.333399999999999	5733	5825	92	5733	2	1.0	TGTGCTAGTGTCAAACGTGATGGTGTGCAA TGTGCTGGTGTTAAACGTGATGGTGTGCAA	5795	4	1.0	CTCACGAGTCAGGAGTGTTAGTGGGCGTGC TTCACGTGTTAAAAGTGTTAGAGGTAGAGC TTCACGTGTTAAGAGTGTCAGTGGTAGAGC TTCACGTGTTAGAAGTGTTAGCGGTAGAGC	2	1.0	GTTGGCTATTGTGACCATGGTGTTAAGT GTTGGTTATTGTGCCCATGGTATTAAGT	{5763} {5763}
5.338535466635869	16337	16581	244	16337	3	1.0	ATCCCAGCACGTGCCAGAGTGGAGTGTTAC ATTCCAGCGCGCGCCAGAGTGGAGTGCTAT ATTCCTGCACGTGCTAGAGTTGAGTGTTAT	16551	2	1.0	TGCCAGCTCCTAGAGTTCTTATCTCTAAAG TTCCAGCCCCTAGGGTGCTTATATCCAAAG	3	1.0	CAATAACAGTGCTCAGTATGTTTTTAGT CAGTGCACAATATGTGTTTAGTACTGTA CGCTACCTGAAGTTAACGCAGATATTGT	{16384} {16390} {16422}
5.340726590941621	13651	13842	191	13651	4	1.0	CTTACAGTTTGTGACAGACCCTGCGCTTAT CTTACAGTTTGTGACAGATCCAACGCTTAT TTTACAGTTTGTGACAGATCCTGCGCTTAT TTTACAGTTTGTGACGGACCCTGCATTAAT	13812	1	1.0	CTCAAGGGTTTTTCGATGAAGGTTCAGAAT	4	1.0	AGTTGCGTCATCGCCTGCCTTGGTGGAC GTAGCAGCTTTGAGTACGGGATTAACAT GTCGCTGCTTTGAGTACTGGGTTGACCT GTTGCGTCATCGCCAGCTTTAGTGGATA	{13681} {13730} {13730} {13682}
5.371157335320482	14322	14418	96	14322	4	1.0	ATGGCGGTTGGGACAATATGCTAAAGAACT ATGGCGGTTGGGATAATATGTTAAAGAACC ATGGTGGCTGGGATAATATGCTAAAGAATC ATGGTGGCTGGGATAATATGTTAAAGAACC	14388	2	1.0	GGGACTATCCCAAGTGTGATAGGGCTATGC GGGACTATCCTAAGTGTGATAGAGCTATGC	2	1.0	CCGATGTTGACGATCCTAAATTGATGGG TGACGTTGACGATCCTAAGTTGATGGGC	{14358} {14359}
5.388489493487164	19084	19182	98	19084	2	1.0	CTCTGCTACTGCTGTGAAAGCAGGTGGTAA CTCTGTTACTGCTGTTAAAACAGGTGGTAA	19152	4	1.0	ACGGTAATGCAATTGCTACTGTCAAATCAG ATGGTAATCCTGTAGCAACAGTTAAGGCAG ATGGTAATGCCATTGCTACTGTCAAATCAG ATGGTAATGCCGTCGCTACTGTCAAATCAG	2	1.0	ATTTGCCAGCCATTCGGTTAAATTTTGG TTGCCGGCTATTAAATTGAATTTTGGAA	{19116} {19118}
5.412848055426138	12639	12740	101	12639	1	1.0	GTGTCCGTGCATTTGACGTTTACAATAAAG	12710	5	1.0	CGCTTCAAAAATGCAGATAAAGATGATGCG CGCTTCAAGAACGCAGATAAGGATGATGCG CGCTTCAAGAATGCAGATAAGGACGATGCG CGCTTCAAGAATGTAGATAAGGATGACGCG CGCTTCAGAAATGCTGATAAGGATGATGCG	2	1.0	CGGCAAAAACTTGAAGTCCAATTGTGTG TGCGTCTTTTATCGGAAAAAATCTGAAG	{12682} {12670}
5.429109836406473	26634	26755	121	26634	4	1.0	TATGGCCATAGCCACACTTGTTATGTGGGT TATGGCCGTATCAACACTCATTATGTGGGT TATGGCCGTATCAACACTCGTTATATGGGT TATGGCTATAGCCACATTTGTTATGTGGGT	26725	2	1.0	CCGGAAGTGAATGCAATCACAGTCACAACC CCTGAGGTTAATGCAATCACTGTCACAACC	1	1.0	TTCAGACTTTTCCGACGTGCTCGAACTT	{26683}
5.4633786676602405	16663	16771	108	16663	3	1.0	CAGATGTCCTGCTGAAATAGTTAACACTGT CAGGTGTCCAGCTGAAATAGTTAACACTGT CAGGTGTCCTGCTGAAATAGTTAATACTGT	16741	3	1.0	TAAGCAGTGCTTCAAAACCTTTGAACGCGG TAAGCAGTGCTTCAAAATCTTTGAACGTGG TAAGCAGTGCTTTAAGATCTTTGAACGTGG	2	1.0	AAAACAAGTTTGTACCAGTCAAAGATGC AAACAAGTTTGTACCTGTCAAAGAAGCT	{16710} {16711}
5.4633786676602405	18444	18552	108	18444	3	1.0	ATGACGACGGTTCATGTGAGGTTGTTCACG ATGATGACGGTCCATGTGAAGTTGTTCATG ATGATGATGGACCCTGTGAGATTGTTCATG	18522	3	1.0	GTAACATTGGTGGAGCAGTTTGTTCCAAAC GTAACATTGGTGGTGCTGTTTGTTCTAAAC GTAATATTGGTGGTGCTGTATGTTCTAAGC	2	1.0	ACCAAGTCAATTATGTTCCTCTTAGGGC TATGTTCCTTTGAGAGCCACTAATTGTA	{18474} {18485}
5.473226686365171	318	413	95	318	3	1.0	GCCGTAGCAAGTGATACTGAAATTTCTGCA GCCGTTGCAAGTGATTCTGAAATTTCTGGA GCTGTTGCAAGTGATACTGAAATTTCTGCA	383	3	1.0	CTATAGCGAGGCCGCTAGCAATGGATTTAG TTATAGCGAGGCCGCTAGCAATGGTTTTAG TTATAGCGAGGCCGCTGTCAATGGTTTTAG	3	1.0	ACTGGCTGTGCCACCGTTGCTCAAGCCG GCTCTACTATTGCGCTAGCCGTCCGCCG GTTGCTCTACTATTGCGCAAACCGTCCG	{348} {355} {352}
5.48667901698314	11671	11804	133	11671	3	1.0	GCTTTGTTCACTACGCAGGTGTTGTTTGGA GTTTTGTGCACTACGCTGGCGTTGTTTGGA GTTTTGTTCACTACGCGGGTGTTGTTTGGA	11774	3	1.0	ACTTGTCTGGCCTCTGATTTTGACATGCGA ACTTGTTTGGCCTCTGATTTTGACTTGTGA ACTTGTTTGGCCTTTGGTTTTGACATGTGA	1	1.0	GTAAGAATGTGCATCTTAAAGATGTTAC	{11728}
5.499589493487164	26924	27022	98	26924	3	1.0	ATAGTAGAGTCGGAAGGTCCGTAAATTCAC ATAGTAGGGTCGGAAGGTCCGTAAATTCAC ATAGTAGGGTCGGGAGGTCTGTCAATTCAC	26992	3	1.0	CACGGTGACTTTTCTGCAGTCAGCTCACCG CACGGTGACTTTTCTGCAGTGAGCTCTCCT CACGGTGATTTTTCTGCAGTGAGCTCCCCC	3	1.0	ACAGGCTGGGTTTTCTACGTACGAGTAA ACAGGCTGGGTTTTCTACGTTCGAGTAA GTAACAACACAGGTTGGATGTTTTATGT	{26962} {26962} {26954}
5.501136002980722	6219	6333	114	6219	5	1.0	ATAGCCAGAGCGCCGCAACGCACAGGTGTT ATGGCCAAAGCACCACAAAGGACGGGTGTT ATGGCCAAAGTACCACAAAGAACGGGTGTT ATGGCTAAAGCACCACAAAGGACAGGTGTT ATGGCTAGAGCACCACAAAGAACGGGTGTT	6303	1	1.0	TCTAAGTGGTGGCTGCTTGCTAAGTTTATG	2	1.0	ACGTAGTCTTAAATATAACTTAAAAGCG ATACAACTTAAAAGCATCGGCAGCCATT	{6257} {6269}
5.5079163730311915	18530	18629	99	18530	3	1.0	GGTGGAGCAGTTTGTTCCAAACATGCTAAC GGTGGTGCTGTATGTTCTAAGCATGCTAAT GGTGGTGCTGTTTGTTCTAAACATGCAAAC	18599	3	1.0	CAAGCTGGCTTTAACATTTGGGTTCCTACC CAAGCTGGTTTTAATATTTGGGTTCCTACC CAGGCTGGTTTCAACATTTGGGTCCCTAAC	3	1.0	TAGAGCATATGTGGAGTCATATAACACT TATATAGGGCATATATTGAGTCATATAA TTATATAGAGCATATGTTGAGTCATACA	{18565} {18561} {18560}
5.520014670640964	11379	11520	141	11379	4	1.0	GAGTTTGACAGAGAGTCGTCTGTTCAAAAG GAGTTTGACAGGGAATCATCTGTTCAAAGG GAGTTTGACAGGGAGTCATCTGTTCAAAAG GAGTTTGATAGGGAATCATCTGTTCAGAAG	11490	2	1.0	AGTGCCATGCATAGTTTACTCTTTGGCATG AGTGCTATGCATCGCTTACTCTTTGGCATG	1	1.0	GCAGAATGGCTGAACAAGCTGCCGCAGC	{11416}
5.531672931341441	11925	12027	102	11925	2	1.0	GGACGTGCATTTATGTATGCATATGTGACT GGCCGTGCATTTATGTATGCGTATGTGACC	11997	4	1.0	GGCGTGGTTACAGTAGAACTAGAACCACCT GGTGTGGTTACAGTTGAATTGGAACCACCT GGTGTGGTTGCAGTGGAATTGGAACCACCT GGTGTTGTTACAGTAGAGTTAGAACCTCCA	3	1.0	ATGAAATATGTTAAATGGGAACATGACT CATGAAGTATGTTAAATGGGAGCATGAC GCCTGACATGAAGTACGTTAAATGGGAA	{11967} {11966} {11960}
5.534911090344212	13037	13127	90	13037	3	1.0	AATGAGGACATACACCGCGTGTACGCTGCT AATGAGGACATACACCGTGTATACGCTGCT AATGAGGACATACACCGTGTGTATGCTGCT	13097	3	1.0	AAATGTGTTGCGCTTTGTGACGAAATGGTT AAGTGTGTTGCTCTTTGCGACGAAATGGTG AAGTGTGTTGCTTTTTGCGATGAAATGGTG	4	1.0	TTAGGCAAGGTAGTCGCAAATGCAATGC TTAGGCAAGGTAGTTGCAAATGCAATGC TTGGGCAAAGTAGTCGCAAATGCAATGA TTGGGTACAGTAGTCGCAAATGCAATGC	{13067} {13067} {13067} {13067}
5.534911090344212	15740	15860	120	15740	4	1.0	GAAACGGTCAAGGCTAAAGAGGAAAGTGTT GAAACTGTCAAAGCTAAGGAGGAAAGTGTT GAAACTGTCAAGGCTAAAGAAGAAAGTGTG GAGACTGTGAAAGCTAAAGAGGAAAGCGTT	15830	2	1.0	TCATGGGAAAGTGGAAAAGCCAAACCACCG TCATGGGAAAGTGGAAAAGCCAAACCGCCA	2	1.0	AAGGAGATTGTAGGTCCTAAGGAACTTT GGAGATTGTAGGCCCTAAGGAACTTTTG	{15797} {15799}
5.539216028494806	6952	7055	103	6952	2	1.0	GTGTAGACTGTGACTCTTATGGTTACGGTA GTGTTGACTGTGACTCTTATGGTTATGGCA	7025	4	1.0	AACCAAGACGAATGTTCAACCCACAGGTCC TACCAAAACAAATGTGCAACCAACAGGCCC TACCAAAACAAATGTTCAGCCAACAGGTCA TACTAAAACAAATGTGCAACCAACAGGTCC	3	1.0	ACACATTTATAACACAAGAGGTTTCTAG ACACTTTTATAACGGCTGAAGTTTCTCG CACCTGAAGTTTCTAGAGAACTTGGTAA	{6982} {6982} {6994}
5.565464373321448	318	444	126	318	3	1.0	GCCGTAGCAAGTGATACTGAAATTTCTGCA GCCGTTGCAAGTGATTCTGAAATTTCTGGA GCTGTTGCAAGTGATACTGAAATTTCTGCA	414	3	1.0	GCATGCCGATTTGTTTCATTAGATTTGCAG GCATGCCGATTTGTTTCATTTGGCTTGCAT GCATGCCGATTTGTTTCATTTGGTTTGCAA	2	1.0	GCGCTAGCCGTCCGCCGCTATAGCGAGG TGCCACCGTTGCGCAAGCCGTCCGCCTT	{366} {356}
5.5797141342961085	8876	9005	129	8876	3	1.0	ATGGTGGCTGTGTGCTTGGTACTTTCTTGC ATGGTGGTTGTGTACTTGGTACTTTTTGGC GTGGTGGCTGTGCGCCTGGTACTTTTTATC	8975	3	1.0	ATTTGTAGGTACATTTGAAAGTGCTGCTGC GTTCGTAGGCACATTTGAAAGTGCTGCTGC GTTTGTGGGTACATTCGAAAGTGCTGCAGC	2	1.0	AATGTTAACAGGTTTGTTACCCAGTTTG TTACCTAGTTTGTTGAAGCTTAAAGTCT	{8906} {8922}
5.581088527362399	9464	9622	158	9464	2	1.0	CCTTGGCGTTGTAGGTGCTACTATGCATGG TCTTGGTGTTGTAGGTGCTACTATGCATGG	9592	4	1.0	GCTATGATGGTTGTGCCCAAGGTGTCTTTG GCTATGATGGTTGTGCTCAGGGTGTTTTTG GTTATGATGGTTGTGCACATGGTGTTTTTG GTTATGATGGTTGTGCCCAAGGTGTTTTCG	1	1.0	TCTTAAAATTAAAGTTTCACAGACTAAC	{9500}
5.581088527362399	17993	18151	158	17993	3	1.0	GACTGGTCAATAACCTACCCTATGATAGCT GACTGGTCAATTACCTATCCTATGATAGCT GATTGGTCAATTACCTACCCTATGATAGCT	18121	3	1.0	TAATCCTAAAGGTATTCGTTGTGCCGTAAC TAATCCTAAGGGTATTCGTTGTGCCGTGAC TAATCCTAAGGGTATTCGTTGTGCTGTAAC	1	1.0	TCATGCGTGCTGCTATTAAATTGTACAA	{18069}
5.587564845367944	16544	16654	110	16544	5	1.0	CAACAATTGCCAGCTCCTAGAGTTCTTATC CAACAGCTGCCAGCTCCTAGAGTTCTTATC CAACAGCTTCCAGCCCCTAGGGTGCTTATA CAACAGTTGCCTGCTCCTAGAGTTCTTATC CAGCAGCTTCCAGCTCCTAGAGTTCTTATC	16624	1	1.0	GTGTGCTATAGGACCTGATGTCTTTTTACA	3	1.0	AATCGATTATAATGTTGTGACACAGCGT AATTGACTATAATGTTGTGACACAACGT TCCAAAGGAACTATGGAACCAGTAGATT	{16594} {16594} {16574}
5.597779016983139	17704	17837	133	17704	2	1.0	CACCATGCGTTATTTTGTAAAGATAGGCTC CACTATGCGTTATTTTGTCAAGATTGGAGC	17807	4	1.0	CACGCTTTGGGTTGTGACTATGTTTACAAC CATGCACTGGGTTGCGACTACGTCTACAAT CATGCATTGGGCTGTGACTATGTTTACAAT CATGCATTGGGCTGTGACTATGTTTATAAC	2	1.0	AAACATTGCCAATGTGGTACTATTGCTA AAACATTGCCAATGTGGTACTGTTGCAA	{17738} {17738}
5.606443513028184	1315	1450	135	1315	3	1.0	GAATGGACACATTCTGTTTCAATGTACGCA GAATGGATACATTCTGCTTCAATGTACGCA GAATGGATACATTCTGCTTCAATGTGCGTA	1420	3	1.0	CAGGTGTCATAGACATTAGTACCGGTTGGT CAGGTGTCATTGACATTAGCACCGGTTGGT CAGGTGTTATTGATATTAGTGCAGGCTGGT	2	1.0	ACCAGTAATGTCAGAAGACAAGTTGCTG TGGCCATGTTAGGTGCTGAATTGACTAG	{1392} {1369}
5.623100082244952	13024	13163	139	13024	2	1.0	TGACCCAGTAGAAAATGAGGACATACACCG TGACCCCATAGAAAATGAGGACATACACCG	13133	4	1.0	GGAGTTGTTGGTGTCCTAACTCTAGACAAC GGAGTTGTTGGTGTCTTGACCTTAGATAAC GGAGTTGTTGGTGTTTTGACCTTAGACAAC GGCGTTGTTGGTGTTTTGACCCTCGATAAT	2	1.0	GTACGCTGCTTTGGGCAAAGTAGTCGCA GTGTTGCTCTTTGCGACGAAATGGTGCT	{13057} {13101}
5.627132422683972	17410	17550	140	17410	2	1.0	CGTTGTTGGTGACAACGTTGGCACTAATGT TGTCACAGGTGATAATGTTGGCACTAATGT	17520	4	1.0	TTGTAAAACCTGTTCGTGCACGTGCACCAC TTGTAAAACCTGTTCGTGCGCGCGCACCAC TTGTAAAACCTGTTCGTGCTCGTGCACCTC TTTTGAAACCTGTTCGTGCACGCGCACCGC	2	1.0	GGTTGTGTTATAACAAACACGGGCAGTG GGTTGTGTTTTAACAAACACTGGCAGTG	{17492} {17492}
5.6295681611474055	7625	7799	174	7625	3	1.0	AAAAGACCAAACACCTATTGTCTGGCATGC AAAGGACCAAACTCCTATTGTCTGGCACGC AAAGGATCAAACTCCTATTGTTTGGCATGC	7769	3	1.0	ACCTGCAACCAGCATTGTTGCTAAACAAGG ACCTGCAACTAGCATTGTTGCTAAGCAAGG ACCTGCTACTAGCATCTTATCTAAACAAGG	1	1.0	GGATTTTAACAGTCTTTCTGCTGAAGGT	{7658}
5.638933761645286	11245	11388	143	11245	2	1.0	CATCATCTTTTGTTGGTATGCCGTCTTTCA CATCGTCTTTTGTTGGTATGCCATCTTTTG	11358	4	1.0	GCAATGAATGTTGCTAAGGCTGAGTTTGAC GCCATGAATGTTGCCAAGGCTGAGTTTGAT GCTATGAATGTTGCAAAAGCTGAGTTTGAC GCTATGAATGTTGCTAAAGCCGAATTTGAC	2	1.0	GACAGGAGTATGAAAACGCAGTTGCAAA GAGTATGAAAATGCTGTTGCAAATGGTT	{11293} {11298}
5.646566666009797	17588	17733	145	17588	4	1.0	AAGGGACAACCGTGGAGTGTGTTGAGAAAA AAGGGACAACCTTGGAGTGTTTTGAGAAAA AAGGGCCAGCCGTGGAGTGTGTTGCGTAAG AGGGGACAACCTTGGAGTGTGTTGAGAAAG	17703	2	1.0	CCACCATGCGTTATTTTGTAAAGATAGGCT CCACTATGCGTTATTTTGTCAAGATTGGAG	2	1.0	CAAATGATAGCAGACTACCTTGCTGGTT CTTGCTGGCTCATCTGATGTATTGGTGT	{17627} {17645}
5.650316028494806	6835	6981	146	6835	4	1.0	CAAAGAGTGCAAGATTGAAGCGATTTCCTA CTAAAAGTGCAAGACTTAAGCGGTTTCCTG CTAAGAGTGCTAGACTTAAGAGATTCCCTG CTAAGAGTGCTAGACTTAAGAGATTTCCAG	6951	2	1.0	TGTGTAGACTGTGACTCTTATGGTTACGGT TGTGTTGACTGTGACTCTTATGGTTATGGC	2	1.0	GGTAGTAAGTTTTGTAAGAAACATAGAT TTAATACAATTGTGAATGGTGTCCAGCG	{6918} {6865}
5.650316028494806	13527	13673	146	13527	2	1.0	GCAGAAAAGTGTTTATTGATGGTGTACCTG GCAGAAAGGTGTTTATTGATGGTGTACCCG	13643	4	1.0	ACTGAACTCTTACAGTTTGTGACAGATCCA ACTGAACTTTTACAGTTCGTGACAGATCCT ACTGAACTTTTACAGTTTGTGACGGACCCT ACTGAGCTCTTACAGTTTGTGACAGACCCT	2	1.0	AGATGTTAATACCCATTCTACCAGACTT GGATGTTAACACTCACTCTACCAGACTT	{13609} {13609}
5.651309836406473	9678	9799	121	9678	5	1.0	GGCTCTCCTGGTTACAATCTTAGAGGTAGC GGTTCCCCCGGCTATAATCTTAAAAATGGC GGTTCCCCTGGCTATAACCTTAAAAATGGC GGTTCCCCTGGTTATAATCTTAAAAATGGC GGTTCTCCTGGCTATAATCTTAAAAATGGC	9769	1	1.0	GCTTTGATGGTGTTATGTATGGTGGTTTTG	3	1.0	GAGGTGGAATTTGTTTATATGCATCAAA GAGGTTGAGTTTTGTTACATGCACCAAA TGCATCAGATTGAACTCGGAAGTGGTAG	{9708} {9708} {9727}
5.661651599001681	11777	11900	123	11777	3	1.0	TGTCTGGCCTCTGATTTTGACCTGCGAACG TGTTTGGCCTCTGATTTTGACTTGTGAACG TGTTTGGCCTTTGGTTTTGACATGTGAACG	11870	3	1.0	TGAAAGCGATGGAGGTCTTAGCAGTGAAGG TGAAGGTGATGGAGGCATTACTAGTGAAGG TGAGGGTGATGGAGGTGTTACTAGTGAAGG	3	1.0	TGAAATAATGCCAGGCAAGATGAAGGTC TGAAATAATGCCGGGCAAGATGAAGGTT TGCCAGGTAAAATGAAGGTCAAAGCCAC	{11828} {11828} {11836}
5.686134243325825	25311	25439	128	25311	4	1.0	CGCGCTCATCTTTGTGGTGAGTATGTTACT CGTGCTCATCTTTGTGGTGAGTATTTTGCT TGTCCTAATTTTTACTGTGGGCTTGCTCTT TGTGTTGATTTTTGTGGTGGGCTTGCTGAT	25409	2	1.0	GCGAATCAACTAAACTTCCTTATTACGACG GTGAGTCAACTAAACTTCCTTATTACGACG	3	1.0	CTGTGGCTTCTTTAGTTGTCTTGCATCT TGCTGTGGTTTCTTTAGTTGTCTTGCTT TGTGGCTGTTGTAGTTGTTTATCGTCGT	{25365} {25363} {25366}
5.693128706359163	12910	13109	199	12910	3	1.0	GGACTTGTGCTTTGCTCTGCGTAACTTTGA GGATTTGTGCTTCGCTCTGCGTAACTTTGA GGATTTGTGTTTTGCCCTGCGTAATTTTGA	13079	3	1.0	GTCGCAAATGCAATGATTAAATGTGTGGCG GTCGCAAATGCAATGCTTAAGTGTGTTGCT GTTGCAAATGCAATGCTTAAGTGTGTGGCT	1	1.0	CTGATTACTTCGAAATGAAGAATTGGTT	{12996}
5.705012910986066	16806	16968	162	16806	4	1.0	GACGCCAACTTGATGTTGTTAAGCGATTTA GGCGCCAACTCGATGTTGTCAAGCGATTTA GGCGTCAACTTGATGTTGTTAAGCGATTTA GTCGACAACTTGACGTCGTCAAGCGTTTTA	16938	2	1.0	ATTCTGCTCAAGGCAGTGAATATGACTATG ATTCTGCTCAAGGTAGCGAGTATGACTATG	2	1.0	ATAAGAACCCTACTTGGAGTAAAGCTGT TGCTAGGCTTTTAGGTTTACAAACTCAG	{16839} {16903}
5.70814041714011	8996	9159	163	8996	3	1.0	TGCTGCAGCTGGTACATTTGTGATTGACAT TGCTGCTGCAGGAACATTTGTTATTGACAT TGCTGCTGCAGGTACGTTTGTTCTAGACAT	9129	3	1.0	GCAGATTACCGCTGTGCTTGTTATGCTTAT GCAGATTACCGTTGTGCTTGTTATGCCTAT GCTGATTACCGTTGTGCTTGTTATGCTTAT	2	1.0	CTTGCTAATAGCATCTCTCCAGAAAAGT GAAAAGCTTGCTAACAGCATTTCGCCAG	{9042} {9036}
5.70814041714011	18389	18552	163	18389	3	1.0	CCAGCTTATGATAAACGTGCTATGGCCAAG CCTGCCTATGATAAGCGCGCCATGGCTAAA CCTGCTTATGATAAACGTGCTATGGCTAAA	18522	3	1.0	GTAACATTGGTGGAGCAGTTTGTTCCAAAC GTAACATTGGTGGTGCTGTTTGTTCTAAAC GTAATATTGGTGGTGCTGTATGTTCTAAGC	2	1.0	TATGTTCCTTTGAGAGCCACTAATTGTA TGCTCCATTTTTCTATTATGATGATGGA	{18485} {18427}
5.70887901698314	9257	9390	133	9257	4	1.0	CAAAATGGCACAACCATCTGGCTTTGTGGA TAAAATGGCACAACCATCTGGCATTGTGGA TAAAATGGCACAGCCATCTGGCATTGTGGA TAAAATGGCGCAGCCGTCTGGCATTGTTGA	9360	2	1.0	CCACGGCACGTTATCGCATCTAATACAACT CCACGTCATGTTATTGCATCTAACACAACT	3	1.0	CTATGGAAACACTGTGTTGAATGGGTTG TCGTGTTTGTTATGGAAACACTGTGTTG TGTTATGGCAACACTGTGTTAAATGGTT	{9308} {9299} {9306}
5.717343925003942	11167	11333	166	11167	3	1.0	TGTCTAAGCATAGTGATTTTGGACTCGGTG TGTCTAAGCATAGTGATTTTGGTCTTGGCG TGTCTAAGCATAGTGATTTTGGTCTTGGTG	11303	3	1.0	TGAAAACGCAGTTGCAAATGGATCGTCACC TGAAAATGCTGTTGCAAATAGTTCCTCACC TGAAAATGCTGTTGCAAATGGTTCTTCACC	2	1.0	TCGTCTTTTGTTGGTATGCCATCTTTTG TTTAGTTGATTCTTATTTTGAGAATGAC	{11247} {11198}
5.719673533078033	11310	11521	211	11310	4	1.0	GCAGTTGCAAATGGATCGTCACCGCAAATT GCTGTTGCAAATAGTTCCTCACCACAAATA GCTGTTGCAAATGGTTCATCACCACAAATC GCTGTTGCAAATGGTTCTTCACCACAAATA	11491	2	1.0	GTGCCATGCATAGTTTACTCTTTGGCATGC GTGCTATGCATCGCTTACTCTTTGGCATGC	1	1.0	GCAGAATGGCTGAACAAGCTGCCGCAGC	{11416}
5.7262905569654325	14313	14482	169	14313	3	1.0	CCAAATTCTATGGCGGTTGGGACAATATGC CCAAGTTTTATGGCGGTTGGGATAATATGT CCAAGTTTTATGGTGGCTGGGATAATATGT	14452	3	1.0	AGGTTCAAAGCACGTCACATGTTGTACGGC AGGTTCTAAACATGTTACATGTTGTACGGC AGGTTCTAAGCATGTCACATGTTGTACGGC	2	1.0	AAGAACTTAATGGCTGACGTTGACGACC ACGATCCTAAATTGATGGGATGGGACTA	{14345} {14367}
5.728054842851936	26634	26849	215	26634	4	1.0	TATGGCCATAGCCACACTTGTTATGTGGGT TATGGCCGTATCAACACTCATTATGTGGGT TATGGCCGTATCAACACTCGTTATATGGGT TATGGCTATAGCCACATTTGTTATGTGGGT	26819	2	1.0	TGAGCGGCGTGCTTTACGTGGACGGACATA TGAGCGGTGTTCTTTACGTGGACGGCCATA	1	1.0	TTCAGACTTTTCCGACGTGCTCGAACTT	{26683}
5.729218128345179	27099	27214	115	27099	4	1.0	GCTGATGAGTCTGAGCAGCAGCGTGGTCGT GCTGATGCATCTGAACCACAACGTGGTCGT GCTGATGCTTCTGAACCACGGCGTGGTCGT GCTGATTCCTCTGAACCACAACGTGGTCGT	27184	2	1.0	CTTGGAAAGTGATACCACGTGACTTGGTAC CTTGGAAGGTGATACCTCGTAATTTGGTAC	4	1.0	CGGGAAGAATTCCATATTCCTTGTACAG GCTAGAATCCCTTATTCTCTTTATAGGC TATTCCCTTTATAGCCCTTTGCTTGTTG TCAGGCAGAATCCCTTTTTCTCTTTATA	{27130} {27132} {27144} {27129}
5.732119205502993	9776	9947	171	9776	2	1.0	TGGTGTTATGTATGGCGGTTTTGATGACCA TGGTGTTATGTATGGTGGTTTTGAAGACCA	9917	4	1.0	GTCTGTAGAACACTACAATGAATGGGCACA GTCTGTAGAACATTATAATGAGTGGGCACA GTCTGTGGAGCATTATAATGAGTGGGCACA GTCTGTTGAACACTATAATGAATGGGCACA	2	1.0	ACCAGATGCTAACAGTTAATGTGGTCGC CCTTCAAGTTGAATCTGCAAACCAGATG	{9832} {9812}
5.732119205502993	16072	16243	171	16072	2	1.0	ATACTCCACCATTTACAAGTTGCATCCATC ATATTCCACCATTTACAAGTTGCACCCATC	16213	4	1.0	CATAGGTATTGGCGTTTATTACCCTGGTGC TATCGGTATTGGTGTGTATTATCCTGGAGC TATTGGTATTGGTGTGTATTACCCTGGAGC TATTGGTATTGGTGTGTATTATCCTGGAGC	2	1.0	ATATGCAAATCTTGTACCGTATTACCAG TGTTAGTGATGCTTATGCAAACCTTGTA	{16120} {16108}
5.7378437654486545	5584	5757	173	5584	4	1.0	GTGACAAGGGTGATGCTGAAGACACTTTGA GTGCCAAAGGTGATGCTGAAGACACTTTGA GTGCTAAGGGTGATGCTGAAGATATTTTGA GTTCTAAGGGTGATGCTGAAGACACTTTGA	5727	2	1.0	ATAGTATGTGCTGGTGTTAAACGTGATGGT ATAGTTTGTGCTAGTGTCAAACGTGATGGT	2	1.0	AGTTATCTAAGTATCTTGCTAATGAAGC AGTTGTCTAAGTATATCGCCAATGAGGC	{5617} {5617}
5.740229730317068	15171	15392	221	15171	5	1.0	GAAAGGTGTTTTATGCGCTTTTAGATTGGG GGAAAGTGTTTTATGCACTGTTAGACTGGG GGAAAGTGTTTTATGCACTTTTGGATTGGG GGAAGGTGTTCTATGCATTGTTAGACTGGG GGAAGGTGTTTTACGCATTGTTAGATTGGG	15362	1	1.0	TCTCAAACAGTTCTAAGATGCGGTGATTGT	1	1.0	CAAGAGTCCAAGTTTTGGGATGAAAGCT	{15269}
5.742214670640964	15977	16199	222	15977	3	1.0	ACGGCCACTACTAAGTTAGTACCTGGTATG ACTGCCACTACAAAATTAGTACCAGGCATG ACTGCCACTACTAAGTTAGTACCAGGTATG	16169	3	1.0	ACAACAATACAGGGTCCGCCTGGTAGTGGT ACCACAATACAGGGTCCTCCTGGTAGTGGA ACTACAATACAGGGTCCCCCTGGTAGTGGT	1	1.0	TTCTCATAATGTTGCTCCACTTAGAGCA	{16021}
5.746148055426138	16806	17030	224	16806	4	1.0	GACGCCAACTTGATGTTGTTAAGCGATTTA GGCGCCAACTCGATGTTGTCAAGCGATTTA GGCGTCAACTTGATGTTGTTAAGCGATTTA GTCGACAACTTGACGTCGTCAAGCGTTTTA	17000	2	1.0	GCTTGTAATGCCAACCGTTTTAACGTAGCT GCTTGTAATGCCAATCGTTTTAACGTTGCC	1	1.0	TTATATTCGCACAGACATCAGATACTGC	{16968}
5.74809679600542	15740	15965	225	15740	4	1.0	GAAACGGTCAAGGCTAAAGAGGAAAGTGTT GAAACTGTCAAAGCTAAGGAGGAAAGTGTT GAAACTGTCAAGGCTAAAGAAGAAAGTGTG GAGACTGTGAAAGCTAAAGAGGAAAGCGTT	15935	2	1.0	GAGAAAGTAGATTATGGTTCTGATACGGTG GAGAAAGTGGATTATGGCTCTGACACGGTG	1	1.0	TGTAGGTCCTAAGGAACTTTTGCTCTCA	{15805}
5.753872931341441	18761	18905	144	18761	3	1.0	GGCGACAAGGTGTTTGTACGTGATGGTAAT GGTGATAAAGTGTTCGTACGTGATGGTAAC GGTGATAAGGTGTTTGTACGTGATGGTAAT	18875	3	1.0	ACACCACCCCTCAGTATTCTCAAAAACCTC ACACCACCTCTCAGTATTCTCAAAAACCTT ACACCACCTCTTAGCATTCTTAAGAACCTA	3	1.0	AATCTAATTTTTGTGAATAAAACATCAC GACAATTTAGTCTTTGTTAATAAGACAT TGAACTTTTCGCAAAGAGGAAGGTTGGT	{18797} {18794} {18844}
5.754428507007025	8526	8705	179	8526	2	1.0	GTTTGCGGTACAGGTCTGTGGGATCTTGTG GTTTGTGGTACTGGTTTGTGGAACCTTGTA	8675	4	1.0	TAGACGCATGTTTGGCGATCTTTCTGTAGG TAGACGCATGTTTGGTGACCTTTCTGTAGG TAGACGCATGTTTGGTGATTTGTCTGTAGG TAGACGTATGTTTGGTGATCTTTCTGTGGG	2	1.0	TAACATACTATCCATGTTTTCATGTTCA TTACTTAATTGTGCATTAGGTGCTTTCG	{8558} {8616}
5.754428507007025	12756	12935	179	12756	3	1.0	GTTGCATTAAGTCAGTTATGGACCACGAGC GTTGTATTAAGTCGGTTATGGACCACGAGC GTTGTGTTAAGTCAGTTATGGACCACGAGC	12905	3	1.0	ATGATGGACTTGTGCTTTGCTCTGCGTAAC ATGATGGATTTGTGCTTCGCTCTGCGTAAC ATGATGGATTTGTGTTTTGCCCTGCGTAAT	2	1.0	AGTCCATGTATAACTTACTTAAAGGCTG TCGCAAAGCATGATTTCTTTACGTGGCA	{12786} {12822}
5.755775410741902	11671	11900	229	11671	3	1.0	GCTTTGTTCACTACGCAGGTGTTGTTTGGA GTTTTGTGCACTACGCTGGCGTTGTTTGGA GTTTTGTTCACTACGCGGGTGTTGTTTGGA	11870	3	1.0	TGAAAGCGATGGAGGTCTTAGCAGTGAAGG TGAAGGTGATGGAGGCATTACTAGTGAAGG TGAGGGTGATGGAGGTGTTACTAGTGAAGG	1	1.0	GTAAGAATGTGCATCTTAAAGATGTTAC	{11728}
5.757111090344212	9166	9346	180	9166	3	1.0	AAGCAATGCTGGATTTTTCGCGTGATCATA AAGCAATGTTGGACTTTTCGCGTGATCATA AGGCCATGATGGACTATTCGCGTGATCATA	9316	3	1.0	ACACTGTGTTAAATGGTTTATGGCTTGGTG ACACTGTGTTGAATGGGTTGTGGCTTGGTG ACACTGTGTTGAATGGTTTGTGGCTTGGAG	2	1.0	TACACACCTCCAACTGTCAGTTATGGTT TATACACCACCAACAGTTAGTTATGGTT	{9207} {9207}
5.761416028494806	3116	3262	146	3116	3	1.0	ACATGAAGGTGACTGGGATAGCTTTTGTAA ACATGAGGGTGACTGGGATAGTTTTTGTAA ACATGAGGGTGATTGGGACAGTTTTTGTGA	3232	3	1.0	TGACTTTGCCTGTCATGATTTCTGAGTGGC TGAGTTTGCCCGTTATGTTTTCTGAATGGC TGAGTTTGCCTGTTATGATTTCTGAATGGC	3	1.0	AACTATTCAATCAGCACTGTCTGTAGTT AACTATTCAATCAGCACTTTCTGTTGTT TACTGTAAATGCAGCTCTTGATGTAGTT	{3146} {3146} {3146}
5.766959109049143	9360	9595	235	9360	2	1.0	CCACGGCACGTTATCGCATCTAATACAACT CCACGTCATGTTATTGCATCTAACACAACT	9565	4	1.0	CTGGCGAAGGTTTTAACATCTTAGCTTGTT CTGGTGAAGGATTTAACATTCTGGCGTGTT CTGGTGAAGGTTTTAACATCCTAGCTTGCT CTGGTGAAGGTTTTAACATCTTAGCATGCT	1	1.0	TCTTAAAATTAAAGTTTCACAGACTAAC	{9500}
5.767622420167963	18445	18629	184	18445	3	1.0	TGACGACGGTTCATGTGAGGTTGTTCACGA TGATGACGGTCCATGTGAAGTTGTTCATGA TGATGATGGACCCTGTGAGATTGTTCATGA	18599	3	1.0	CAAGCTGGCTTTAACATTTGGGTTCCTACC CAAGCTGGTTTTAATATTTGGGTTCCTACC CAGGCTGGTTTCAACATTTGGGTCCCTAAC	2	1.0	GGAGCAGTTTGTTCCAAACATGCTAACT TATGTTCCTTTGAGAGCCACTAATTGTA	{18533} {18485}
5.772751599001681	1157	1343	186	1157	3	1.0	AACGCAGAAAGCAGGCGTTGGTATTAAGTA AACTCAGCAAGCTGGTGCTGGTATTAAGTA TACTCAGCAAGCTGGTGTTGGTGTTAAGTA	1313	3	1.0	CAGAATGGATACATTCTGCTTCAATGTACG TAGAATGGACACATTCTGCTTCAATGTACG TAGAATGGATACACTCTGCTTCAATGTGCG	2	1.0	CTTAAGTTTGTTGCAAACATTGAAGGTG GTCTGGCGAGTAATCGCTGTTCAAAGTG	{1203} {1236}
5.774203865708118	20322	20561	239	20322	3	1.0	CATCAGAAGCCTTTGTGATCGGAATCAACT CATCAGAAGCCTTTGTTGTCGGAATTAACT CGTCAGAGGCCTTTGTCATAGGCATAAACT	20531	3	1.0	GAAATGGTGCTCAGTCTTATTAAGAGTGGT GAAATGGTGCTTAGTCTTGTTAGGAATGGT GACATGGTGCTTAGTCTTGTTAGGAGTGGT	1	1.0	TGAGTTTGTCCTACAACTCTGTTTTAGA	{20436}
5.77953196905215	12693	12935	242	12693	3	1.0	TGAAGTCCAATTGTGTGCGCTTCAAAAATG TGAAGTCCAATTGTGTGCGCTTCAAGAACG TGAAGTCTAATTGTGTGCGCTTCAAGAATG	12905	3	1.0	ATGATGGACTTGTGCTTTGCTCTGCGTAAC ATGATGGATTTGTGCTTCGCTCTGCGTAAC ATGATGGATTTGTGTTTTGCCCTGCGTAAT	1	1.0	TTAAACGTTGTATTAAGTCAGTTATGGA	{12750}
5.786501087828205	15937	16183	246	15937	2	1.0	GAAAGTAGATTATGGTTCTGATACGGTGAC GAAAGTGGATTATGGCTCTGACACGGTGAC	16153	4	1.0	AGGCAAACAGCGTATTACTACAATACAGGG TGGAAAACAACGCATCACTACAATACAGGG TGGCAAACAGCGTATCACCACAATACAGGG TGGTAAACAACGCATTACTACAATACAGGG	1	1.0	TTCTCATAATGTTGCTCCACTTAGAGCA	{16021}
5.788219948987033	14586	14833	247	14586	4	1.0	GTGACGCGACTACTGCTTATGCTAACTCTG GTGATGCAACTACAGCCTACGCCAATTCTG GTGATGCAACTACAGCTTATGCTAATTCTG GTGATGCAACTACTGCTTATGCCAACTCTG	14803	2	1.0	GATGATCCTTTCTGATGACGGTGTTGTGTG GATGATTCTTTCTGATGATGGTGTTGTGTG	1	1.0	TAATCGCATTTTGAGCGTTAACTCGTCA	{14650}
5.789929642842771	17837	17991	154	17837	4	1.0	CCATATGTCATAGACATTCAACAATGGGGT CCATATGTCATAGATATCCAACAATGGGGT CCATATGTCATAGATGTACAACAATGGGGT CCATATGTGATTGATATACAACAGTGGGGC	17961	2	1.0	TGGCCGTCTATGACTGTTTTGTTAAGAATG TGGCTGTGTATGACTGCTTTGTTAAGAATG	3	1.0	GCCATTTGTAATGTTCATAGAAATGAGC GGTTCTCTTTCCACAAATCACCATGCTA TCTCCAATAATCACCATGCAATTTGTAA	{17897} {17873} {17880}
5.790083757168364	16174	16367	193	16174	3	1.0	AATACAGGGTCCACCTGGTAGTGGTAAATC AATACAGGGTCCCCCTGGTAGTGGTAAGTC AATACAGGGTCCTCCTGGTAGTGGAAAATC	16337	3	1.0	ATCCCAGCACGTGCCAGAGTGGAGTGTTAC ATTCCAGCGCGCGCCAGAGTGGAGTGCTAT ATTCCTGCACGTGCTAGAGTTGAGTGTTAT	2	1.0	CCATAGGTATTGGCGTTTATTACCCTGG CTATCGGTATTGGTGTGTATTATCCTGG	{16212} {16212}
5.797234243325825	15664	15860	196	15664	4	1.0	CACATCTGATTGGTCTGATATCCGTGACTA TACCTCTGATTGGTCTGACATTCGCGACTA TACTTCAGACTGGTCTGACATACGTGACTA TACTTCTGATTGGTCTGACATTCGTGACTA	15830	2	1.0	TCATGGGAAAGTGGAAAAGCCAAACCACCG TCATGGGAAAGTGGAAAAGCCAAACCGCCA	2	1.0	AAGGAGATTGTAGGTCCTAAGGAACTTT GGAGATTGTAGGCCCTAAGGAACTTTTG	{15797} {15799}
5.804228706359162	8996	9195	199	8996	3	1.0	TGCTGCAGCTGGTACATTTGTGATTGACAT TGCTGCTGCAGGAACATTTGTTATTGACAT TGCTGCTGCAGGTACGTTTGTTCTAGACAT	9165	3	1.0	AAAGCAATGCTGGATTTTTCGCGTGATCAT AAAGCAATGTTGGACTTTTCGCGTGATCAT AAGGCCATGATGGACTATTCGCGTGATCAT	2	1.0	CTTGCTAATAGCATCTCTCCAGAAAAGT GAAAAGCTTGCTAACAGCATTTCGCCAG	{9042} {9036}
5.806526686365171	16453	16653	200	16453	5	1.0	CGTAGATGAAGTGTCTATGTGCACCAATTA CGTAGATGAAGTGTCTATGTGCACTAACTA CGTGGATGAGGTGTCTATGTGCACTAACTA TGTAGATGAGGTGTCTATGTGCACCAACTA TGTGGATGAAGTGTCCATGTGCACTAACTA	16623	1	1.0	TGTGTGCTATAGGACCTGATGTCTTTTTAC	2	1.0	CAACAGCTGCCAGCTCCTAGAGTTCTTA CCCTCAACAGCTTCCAGCCCCTAGGGTG	{16544} {16540}
5.806526686365171	19489	19689	200	19489	4	1.0	AGCAGCATCTGACGTAACACTCAAATGCTG GGCAGCATCTGATATTACACTCAAATGTTG GTCAGCATCTGACATAACACTCAAATGTTG TGCTGCGTCTGATGTAACACTTAAGTGCTG	19659	2	1.0	AACCATGGAGATGGATGCTATGGTGTAAAG AACCATGGCGATGGATGCTTTGGTGTAAAG	2	1.0	GACCTATCTTAATGATCCTAGCTCTAAG GACTTTGTTGCTATATTAAAATCTTTGG	{19525} {19586}
5.809764845367944	14044	14204	160	14044	1	1.0	TGGTTGGCCACTTAATAAGTTTGGTAAAGC	14174	5	1.0	TACGCCATATCAGGCAAGGAACGTGCGCGT TACGCCATATCTGGTAAGGAACGTGCACGT TACGCCATATCTGGTAAGGAGCGAGCACGT TACGCCATATCTGGTAAGGAGCGTGCGCGT TATGCCATATCTGGTAAGGAACGTGCACGT	3	1.0	CTATTAGTTATGAGGAACAAGATGCCAT TCTATTAGCTATGAGGAACAAGACGCAA TTAGTTATGAAGAACAAGACGCTATGTT	{14091} {14090} {14094}
5.81107380995394	13711	13842	131	13711	5	1.0	ACGCACTGTATGCTTTTCTGTCGCAGCTCT ACGCACTGTTTGCTTTTCTGTAGCAGCTTT ACGCACTGTTTGCTTTTCTGTTGCTGCTTT ACGCACTGTTTGTTTTTCTGTCGCTGCTTT ACGTACTGTTTGCTTTTCCGTCGCTGCTTT	13812	1	1.0	CTCAAGGGTTTTTCGATGAAGGTTCAGAAT	4	1.0	AGTACAGGATTAACATCCCAAACCGTAA AGTACAGGGTTGACATCTCAAACAGTAA AGTACGGGCTTAACATCCCAAACAGTAA AGTACTGGGTTGACCTCTCAGACAGTGA	{13742} {13742} {13742} {13742}
5.8264992452466915	7479	7688	209	7479	5	1.0	GCACACCGTTATGATGTGTTGTTATCAGAT GCACATCGTTGTGACGTGTTGTTATCTGAT GCACATCGTTGTGACGTTTTGTTGTCTGAT GCGCATCGTTGTGACGTGTTGTTGTCTGAC GCTCATCGTTGTGATGTGTTGTTGTCTGAC	7658	1	1.0	GGATTTTAACAGTCTTTCTGCTGAAGGTCG	2	1.0	GACAAAAGACCAAACACCTATTGTCTGG GATGAAAAATTATCAGCTTATGACTTGG	{7622} {7548}
5.828643513028184	1208	1343	135	1208	3	1.0	GTTCGTAGCTAGCATTGAGGGCGTTTCTGT GTTTGTTGCAAACATTGAAGGTGTCTCTGT GTTTGTTGCAAGCATTGAATGTGTCGCTGT	1313	3	1.0	CAGAATGGATACATTCTGCTTCAATGTACG TAGAATGGACACATTCTGCTTCAATGTACG TAGAATGGATACACTCTGCTTCAATGTGCG	4	1.0	GCTTTGTTGCTTCTTCCACTTTTGTAGA GGCGAGCAATTGCTGTTCAGAGTGTTGA TGGCGAGTAATCGCTGTTCAGAGTGTGG TGGCGAGTGATTGCTGTTCAAAGTGTAG	{1270} {1240} {1239} {1239}
5.828643513028184	25275	25485	210	25275	2	1.0	CAAGTGGCCGTGGTGGGTGTGGTTGTGCAT TAAGTGGCCATGGTGGGTGTGGTTGTGTAT	25455	4	1.0	ACAGTAATGGCTCTAGGTTTGTTCACATTG ACAGTAATGGCTCTAGGTTTGTTTACTCTG ACAGTAATGGCTTTAGGCTTGTTCACATTG TCAGTAATGGCTCTAGGCTTGTTCACACTT	2	1.0	AGGTTGTTGTGAGTCAACTAAACTTCCT GTCGCGCTCATCTTTGTGGTGAGTATGT	{25401} {25309}
5.8344360029807225	19669	19837	168	19669	2	1.0	ATGGATGCTATGGTGTAAAGACAATGCTGT ATGGATGCTATGGTGTAAAGATAATGCCGT	19807	4	1.0	TTACGGTGCAGGTTTAAAATTACCCAATGG TTACGGTGCGGGTTTGAAGTTACCTAGTGG TTATGGTGCAGGTTTAAAGTTGCCTAGTGG TTATGGTGCAGGTTTGAAGTTGCCCAGTGG	3	1.0	ATTCTACCCTCAATTGCAAAGTGCAGAA CTATGCCTGGCATTTACAAGATACAAAG TATCCTCAGTTACAGAGTGCAGAATGGA	{19705} {19749} {19709}
5.8370799693424065	9800	10014	214	9800	3	1.0	AGACCAACCTAACCTTCAAGTTGAATCTGC GGACCAACCTAACCTTCAGGTTGAATCTGC TGACCAACCTAACCTTCAAGTTGAATCTGC	9984	3	1.0	TTCTCCATTCTTGCTGCTAAAACTGGCGTT TTTTCCATTCTTGCTGCTAAAACTGGTGTC TTTTCTATTCTTGCTGCAAAAACCGGTGTC	2	1.0	AACCAGATGCTAACAGTCAATGTGGTAG ACTATAATGAATGGGCACAGTCCAATGG	{9831} {9928}
5.8370799693424065	20117	20331	214	20117	3	1.0	GATGGCAGGACAAAGGCAATTGATGGTGAA GATGGCAGGACAAAGTCGATTGATGGGGAG GATGGTAAGACAAAGGCAATTGATGGTGAA	20301	3	1.0	GCACATCTGTTAACACCTCATCATCAGAAG GCACTTCTGTTAATACATCGTCGTCAGAGG GCACTTCTGTTAATACGTCATCATCAGAAG	2	1.0	ATTTGTGAAAAACTTGCCATAGGAGGTT TTGTATGAACTTGTACAAAAATTTTCTT	{20189} {20258}
5.843219205502994	18603	18774	171	18603	3	1.0	CTGGCTTTAACATTTGGGTTCCTACCACGT CTGGTTTCAACATTTGGGTCCCTAACACAT CTGGTTTTAATATTTGGGTTCCTACCACGT	18744	3	1.0	TACCAGTAGCCATTAGTGGTGATAAAGTGT TACCAGTGGCTATTAGTGGTGATAAAGTGT TACCTGTGGCTATTAATGGCGACAAGGTGT	3	1.0	TGATTGTTATAATTTGTGGCAGACATTT TGCTACAATCTGTGGCAAACATTTACAG TGGCAAACCTTTACTGAGGTTAATTTGC	{18634} {18638} {18650}
5.843264730403719	9129	9346	217	9129	3	1.0	GCAGATTACCGCTGTGCTTGTTATGCTTAT GCAGATTACCGTTGTGCTTGTTATGCCTAT GCTGATTACCGTTGTGCTTGTTATGCTTAT	9316	3	1.0	ACACTGTGTTAAATGGTTTATGGCTTGGTG ACACTGTGTTGAATGGGTTGTGGCTTGGTG ACACTGTGTTGAATGGTTTGTGGCTTGGAG	2	1.0	AGCAATGTTGGACTTTTCGCGTGATCAC GCAAAGGCCATGATGGACTATTCGCGTG	{9167} {9162}
5.846094263681199	5197	5369	172	5197	3	1.0	CAGACAAGTCATTTGAACAACAAGTTGGTG CGGACAAACCATTTGAGCAGCAGGTTGGCG CGGATAAGTCGTTTGAGCAACAAGTTGGTG	5339	3	1.0	AGACGCCACTACATTTGCAACATTAGATCA AGACGCTGTTACTTTTGCAACAGTTGATCA AGATGCTGTAACCTTTGCAACAGTTGATCA	3	1.0	AGCGATCTTAATACATCAGAATTGCTTA TAAAGACAAAGATCTTTCTGGTGCAGTA TTGCGGACAAGGATGTGGACCTTTCTGG	{5268} {5237} {5230}
5.849332422683972	11423	11643	220	11423	1	1.0	GGCTGAACAAGCTGCTGCAGCTATGTATAA	11613	5	1.0	GCCAGGCTCGTCGTCGTAGTGCCAGATCAT TCCAAACTCGTCGTTGTAGTACCAGATCAT TCCAAGCTCGTCGTCGTGGTGCCAGATCAT TCCAAGCTTGTTGTTGTAGTACCAGATCAT TCCAAGCTTGTTGTTGTAGTGCCAGATTAT	2	1.0	GTTGTTAGTGCAATGCATAGTTTACTCT TGCAGTTAATAGAAAATCAAAGGTTGTT	{11484} {11462}
5.849332422683972	17326	17546	220	17326	2	1.0	TGGCAGTCACAGTTTGTTCTGCACCAGAGA TGGCAGTCATAGTTTGTTCTGTACTAGAGA	17516	4	1.0	AGTGTTATAAAACCTGTTCGTGCTCGTGCA AGTGTTGTAAAACCTGTTCGTGCACGTGCA AGTGTTGTAAAACCTGTTCGTGCGCGCGCA AGTGTTTTGAAACCTGTTCGTGCACGCGCA	2	1.0	CAGAAGGTTGTGTTTTAACAAACACAGG TGTGGAAGGTGCACATGTCACAGGTGAC	{17487} {17395}
5.851329730317068	8484	8705	221	8484	2	1.0	GACAAGTGGTTTGTTAATGATGGAAGTGTG GACAAGTGGTTTGTTAATGATGGACGTGTT	8675	4	1.0	TAGACGCATGTTTGGCGATCTTTCTGTAGG TAGACGCATGTTTGGTGACCTTTCTGTAGG TAGACGCATGTTTGGTGATTTGTCTGTAGG TAGACGTATGTTTGGTGATCTTTCTGTGGG	2	1.0	TAATGGTTATGTTTGCGGTACAGGTCTG TGGTTATGTTTGTGGTACTGGTTTGTGG	{8516} {8519}
5.851329730317068	9056	9277	221	9056	2	1.0	CTCTCCAGAAAAGTTGAAAAGTTATGCTGC TTCGCCAGATAAGTTGAAAAGTTATGCAGC	9247	4	1.0	CAGGTTTGCGTAAAATGGCACAGCCATCTG CAGGTTTGCGTAAAATGGCGCAGCCGTCTG CTGGCCTGCGTAAAATGGCACAACCATCTG CTGGTTTGCGCAAAATGGCACAACCATCTG	2	1.0	TATGCTTATTTGGCAAAGGCCATGATGG TTGTTATGCATATCTAGCAAAAGCAATG	{9150} {9146}
5.85456788931984	18937	19112	175	18937	4	1.0	GGATTATGAAGCAGAACGTCCTCTAACTAG GGATTATGAAGCTGAACGTCCTTTGACTAG GGATTATGAAGCTGACCGGCCCTTGACAAG GGATTATGAAGCTGAGCGTCCCTTTACAAG	19082	2	1.0	TTCTCTGCTACTGCTGTGAAAGCAGGTGGT TTCTCTGTTACTGCTGTTAAAACAGGTGGT	3	1.0	ACAAAGTCTGTCTGTGGTTACACAGATT ACAAAGTCTGTTTGTGGTTACACAGATT TCTGTTTGTGGTTATACAGACTTTACAG	{18971} {18971} {18977}
5.855287395870145	9257	9480	223	9257	4	1.0	CAAAATGGCACAACCATCTGGCTTTGTGGA TAAAATGGCACAACCATCTGGCATTGTGGA TAAAATGGCACAGCCATCTGGCATTGTGGA TAAAATGGCGCAGCCGTCTGGCATTGTTGA	9450	2	1.0	TCAGGCTCTGTGTTCCTTGGCGTTGTAGGT TCTGGTACAGCATTTCTTGGTGTTGTAGGT	2	1.0	TTATCGCATCTAACACAACTTCTGCTAT TTGTTATGGTAACACTGTGTTGAATGGT	{9370} {9305}
5.863059093787734	16024	16251	227	16024	1	1.0	TCATAATGTTGCTCCACTTAGAGCACCAAC	16221	5	1.0	TTGGCGTTTATTACCCTGGTGCACGTATCG TTGGTGTGTATTACCCTGGAGCGAGGATCG TTGGTGTGTATTACCCTGGTGCAAGAATTG TTGGTGTGTATTATCCTGGAGCAAGAATTG TTGGTGTGTATTATCCTGGTGCACGCATTG	2	1.0	CACCCATCATTTAATGTTAGTGATGCTT CCATCGTTTAATGTTAGCGATGCATATG	{16094} {16097}
5.87437439218088	17023	17256	233	17023	2	1.0	CGTAGCTATTACAAGGGCTAAGAAGGGTAT CGTTGCCATTACTAGAGCAAAGAAAGGCAT	17226	4	1.0	AAACTAGTGGCGATTTGGCTGTCCAAATAG AGACTAGTGGTGACTTAGCTGTCCAGATAG AGACTAGTGGTGACTTGGCTGTTCAAATAG AGACTAGTGGTGATTTAGCTGTTCAGATAG	2	1.0	CTTTTGTATCATGTCAGATAAGAGTTTG TGCACTTAAATTCTTTGAAATCACTATG	{17053} {17086}
5.887089758004453	18389	18629	240	18389	3	1.0	CCAGCTTATGATAAACGTGCTATGGCCAAG CCTGCCTATGATAAGCGCGCCATGGCTAAA CCTGCTTATGATAAACGTGCTATGGCTAAA	18599	3	1.0	CAAGCTGGCTTTAACATTTGGGTTCCTACC CAAGCTGGTTTTAATATTTGGGTTCCTACC CAGGCTGGTTTCAACATTTGGGTCCCTAAC	2	1.0	TATGTTCCTTTGAGAGCCACTAATTGTA TGCTCCATTTTTCTATTATGATGATGGA	{18485} {18427}
5.89063196905215	18532	18774	242	18532	3	1.0	TGGAGCAGTTTGTTCCAAACATGCTAACTT TGGTGCTGTATGTTCTAAGCATGCTAATCT TGGTGCTGTTTGTTCTAAACATGCAAACCT	18744	3	1.0	TACCAGTAGCCATTAGTGGTGATAAAGTGT TACCAGTGGCTATTAGTGGTGATAAAGTGT TACCTGTGGCTATTAATGGCGACAAGGTGT	2	1.0	ACATTTGGGTTCCTACCACGTTTGATTG GTTTCAACATTTGGGTCCCTAACACATT	{18612} {18606}
5.902730266661922	11438	11687	249	11438	3	1.0	TGCAGCTATGTACAAAGAAGCACGTGCTGT TGCAGCTATGTACAAGGAAGCACGTGCAGT TGCAGCTATGTATAAAGAAGCACGTGCAGT	11657	3	1.0	AATGATGGTAGATGGTTTTGTGCACTACGC AATGATGGTAGATGGTTTTGTTCACTACGC AATGTTGGTAGATGGTTTTGTGCACTATGC	2	1.0	ATCAAAGGTTGTTAGTGCTATGCATCGC GTTGTTAGTGCAATGCATAGTTTACTCT	{11477} {11484}
5.904421916171136	17155	17405	250	17155	3	1.0	TTGTGCACGTAACCCAATAGATTTGCCACC TTGTGCACGTAACCCCATTGATTTACCACC TTGTGCACGTAACCCTATTGATTTACCACC	17375	3	1.0	AGAGGTTGGCTAGGAATGGATGTGGAAGGT AGAGGTTGGTTAGGAATGGATGTAGAAGGT AGAGGTTGGTTAGGTATGGATGTTGAAGGT	2	1.0	ACTACTTATCTATCATTGTCTGATAGAT TAGCCATGCCACTACGTATTTGTCACTT	{17195} {17185}
5.90777866766024	15605	15761	156	15605	2	1.0	GGTTTGTACAAAAGTTCTGCGCTGGGTTCC GGTTTGTACAAAAGTTCTGCTTTGGGTTCC	15731	4	1.0	TTCGCAGCTGAAACTGTCAAGGCTAAAGAA TTTGCAGCTGAAACGGTCAAGGCTAAAGAG TTTGCAGCTGAAACTGTCAAAGCTAAGGAG TTTGCAGCTGAGACTGTGAAAGCTAAAGAG	4	1.0	AATAAGCTTTCTACTTCTGATTGGTCTG GCTAATGATGCAAAAGAGTCACTAAGGT GTAGACGTAGATGTTTTTAATAAGCTCT TGGCTAATGAAGCTAAGGAGTCACTAAG	{15653} {15701} {15635} {15699}
5.911100633533979	13915	14072	157	13915	5	1.0	CAGACCCACCATGCTAGATATTGGACAAGC CAGACCTACCATTCTGGATATTGGACAAGC CAGACCTACTATGTTGGATATAGGACAAGC TAGACCCACTATGTTAGATATTGGACAAGC TAGACCTACTATGCTGGATATTGGACAAGC	14042	1	1.0	GCTGGTTGGCCACTTAATAAGTTTGGTAAA	4	1.0	CGCGTAGCATATCAAGTGGCATCTCGCT GTGTAGCATACCAAGTAGCATCTCGCTA TCGTGTAGCTTACCAAGTTGCTTCACGC TGTATTACATCTAGAGAGGTGGTTGTTA	{13946} {13947} {13945} {13997}
5.942553964378334	27185	27352	167	27185	2	1.0	TTGGAAAGTGATACCACGTGACTTGGTACC TTGGAAGGTGATACCTCGTAATTTGGTACC	27322	4	1.0	ACTACCTTGGAACAGGTCCCTACCCAGATG ACTATTTGGGCACAGGACCACATAAGGAAT ATTATCTTGGCACAGGACCCCATAAAGATG ATTATTTGGGCACAGGACCGCATCAAGATG	4	1.0	ACAAGAAAGATAAAGACAAGCTTATAGG ACTAACAAGGGTGACAAAGACAAGTTTG CTATTGGAATGTTCAAAAACGTTTCAGA TACTAACAAGAAGGAAAAAGACAAGCTT	{27220} {27216} {27248} {27215}
5.946091578646308	26122	26335	213	26122	4	1.0	GATGTTCCTGAAATTAGTGGATGATCATGC GATGTTCCTGAAGCTAGTTGATGATCACGC GATGTTCCTTAAGCTAGTGGATGATCATGC GATGTTTCTGAAGCTAGTGGATGATCATGC	26305	2	1.0	CCAATCATACATGCACATAGACCCTTTCCC CCAGTCTTATATGCACATAGACCCTTTTCC	3	1.0	TATGCATAACATTAATTAAACTAATCAA TGCCATATGTTTTGTAATAAAACGATTT TTGATTGTTAATGTACTACTCTGGTGTG	{26205} {26246} {26153}
5.9484905569654325	15331	15500	169	15331	2	1.0	ACAAGCTGCTGGTCTTTGTGTAGTATGTGG TCAAGCAGCTGGCCTGTGTGTAGTATGTGG	15470	4	1.0	ACACCATATGTGTGTAACACATCTGGTTGC ACACCATATGTTTGTAACACATCTGGCTGC ACACCTTATGTGTGTAACACATCTGGCTGC ACACCTTATGTTTGTAACACATCTGGTTGC	4	1.0	CTTATGATCATGTGTTTGGAACTGATCA CTTATGATCATGTGTTTGGCACGGATCA GTGTTTGGCACTGATCATAGGTTCATTT TGCTTATGATCATGTGTTTGGCACGGAT	{15423} {15423} {15434} {15421}
5.968448055426139	13753	13854	101	13753	4	1.0	AACATCCCAAACAGTAAAACCTGGCCATTT AACATCCCAAACCGTAAAACCCGGCCATTT GACATCTCAAACAGTAAAACCTGGCCATTT GACCTCTCAGACAGTGAAACCTGGCCATTT	13824	3	1.0	TCGATGAAGGATCAGAATTGACTTTGAAGC TCGATGAAGGTTCAGAATTGACATTGAAGC TCGATGAGGGTTCAGAATTAACATTGAAGC	1	1.0	TTATGACTTCTTACGCTCTCAAGGGTTT	{13795}
5.968543377117347	9592	9681	89	9592	4	1.0	GCTATGATGGTTGTGCCCAAGGTGTCTTTG GCTATGATGGTTGTGCTCAGGGTGTTTTTG GTTATGATGGTTGTGCACATGGTGTTTTTG GTTATGATGGTTGTGCCCAAGGTGTTTTCG	9651	3	1.0	CGAGGTTCATTTATTAATGGTGCATGTGGT CGTGGTTCATTCATTAATGGTGCATGTGGC CGTGGTTCATTTATTAATGGTGCGTGTGGT	2	1.0	GTGTGAACATGAGAACTAACTGGACTAT GTGTGAACATGAGGACCAATTGGACTAT	{9622} {9622}
5.979411090344213	8518	8608	90	8518	2	1.0	ATGGTTATGTTTGCGGTACAGGTCTGTGGG ATGGTTATGTTTGTGGTACTGGTTTGTGGA	8578	5	1.0	CATCCTCATTTTCTGTTGCCGCAATGTCAG CATCTTCATTTTCTGTTGCTGCAATGTCAG CATGTTCATTTTCTGTAGCTGCAATGTCAG CATTATCGTTCTCTGTAGCCGCAATGTCAG CGTCCTCATTCTCTATTGCTGCAATGTCAG	2	1.0	ACCTTATACTCAATGTGTTTTCCATGTT ACCTTGTATTTAACATACTTTCCATGTT	{8548} {8548}
5.979411090344213	9926	10016	90	9926	4	1.0	ACACTATAATGAATGGGCACAGTCCAATGG ACATTACAATGAATGGGCACAGACTAATGG ACATTATAATGAGTGGGCACAGGCTAATGG GCATTATAATGAGTGGGCACAGTTTAATGG	9986	3	1.0	CTCCATTCTTGCTGCTAAAACTGGCGTTTG TTCCATTCTTGCTGCTAAAACTGGTGTCTG TTCTATTCTTGCTGCAAAAACCGGTGTCTG	2	1.0	TCACAGCTATGAATGGCGAAGATGCCTT TTACAGCCATGAATGGTGAAGATGCCTT	{9958} {9958}
5.989159109049143	8163	8398	235	8163	3	1.0	GCCTTTGGTAGTGCAGGTGTCTGTTATGAC GCGTTTGGTAATGCTGGTGTGTGTTATGAC GCTTTTGGTAATGCTGGTGTTTGTTATGAC	8368	3	1.0	AATTGCCAGAAGTAATTGCACAGGGTTTTG AATTGCCGGAAATAATTGCACAGGGCTTTG AGTTGCCAGAAGTTATTGCACAAGGCTTTG	3	1.0	TATTTGGAGTTACTACACCTGAAAAGTG TCTTTGGAGTCACAACACCGGAAAAGTG TGGCGTCACAACACCTGAAAAGTGCATT	{8194} {8194} {8198}
6.026428706359162	13825	14024	199	13825	3	1.0	CGATGAAGGATCAGAATTGACTTTGAAGCA CGATGAAGGTTCAGAATTGACATTGAAGCA CGATGAGGGTTCAGAATTAACATTGAAGCA	13994	3	1.0	GGCTGTATCACATCTAGAGAAGTGGTTGTT GGCTGTATTACATCTAGAGAGGTTGTTGTT GGTTGTATTACATCTAGAGAGGTGGTTGTT	4	1.0	AAGCTCGTGTAGCTTACCAAGTTGCTTC ATGTTAGATATAGGACAAGCACGTGTAG TCAAGTAGCATCTCGTTACTTTGACTGC TGGATATTGGACAAGCGCGCGTAGCATA	{13941} {13925} {13957} {13929}
6.037757335320481	11065	11197	132	11065	3	1.0	CAAAGGAGTGGGCATATTGTGTTGAAACAC CAAAGGAGTGGGCATATTGTGTTGAAACGC CAAAGGAGTGGGCGTATTGTGTTGAAATGC	11167	3	1.0	TGTCTAAGCATAGTGATTTTGGACTCGGTG TGTCTAAGCATAGTGATTTTGGTCTTGGCG TGTCTAAGCATAGTGATTTTGGTCTTGGTG	6	1.0	AAACTTGTGTGACGACCCTGAGACGGCG AACTGCCCAAGAATTGTTGCTTGCGTTG CCCGAAATTGCTCAGGAGCTGTTGCTGG TGACGACCCTGAAACTGCTCAAGAGTTA TGAGTTAGCCCAAGAGCTGCTGTTAGCC TGATAACCCCGAAACTGCTCAGGAGCTG	{11105} {11126} {11121} {11114} {11123} {11114}
6.055189493487164	1352	1450	98	1352	4	1.0	AACTGATGAGTGTCGATTGGCCATGTTAGG TACTGATGAGTGTCGTATAGCTATGTTAGG TACTGATGAGTGTCGTTTGGCCATGTTGGG TGTTGATGAGTGTCGTATGGCCATGTTGGG	1420	3	1.0	CAGGTGTCATAGACATTAGTACCGGTTGGT CAGGTGTCATTGACATTAGCACCGGTTGGT CAGGTGTTATTGATATTAGTGCAGGCTGGT	2	1.0	ACCAGTAATGTCAGAAGACAAGTTGCTG TTGACTAGTAATGCCAGAAAACAAATTG	{1392} {1389}
6.065464730403719	19725	19942	217	19725	2	1.0	GTGCAGAATGGAAATGCGGATATTCTATGC GTGCAGAATGGAAATGTGGTTACTCTATGC	19912	4	1.0	TATGAGAGTATTACATTTAGGTGCTGGGTC TATGAGAGTGTTACACTTAGGTGCTGGTTC TATGAGAGTGTTACACTTGGGTGCTGGCTC TATGAGGGTACTACATTTAGGTGCAGGTTC	4	1.0	CAGGCATTTATAAAGTGCAACGAATGTG CTGGCATTTACAAGATACAAAGAATGTG GCGGGTTTGAAGTTACCTAGTGGCATTA GTATAATTATGGTGCAGGTTTGAAGTTG	{19755} {19755} {19814} {19801}
6.079548055426138	16723	16824	101	16723	3	1.0	ACCAGTCAAAGATGCCAGTAAGCAGTGCTT ACCCGTCAAAGAGGCTAGTAAGCAGTGCTT ACCTGTCAAAGAAGCTAGTAAGCAGTGCTT	16794	4	1.0	CCAGTATAAACAGGCGCCAACTTGATGTTG CCAGTATAAACCGTCGACAACTTGACGTCG CCAGTATAAATAGACGCCAACTTGATGTTG CCAGTATAAATAGGCGTCAACTTGATGTTG	2	1.0	AAAATCTTTGAACGCGGTAGTGTTCAGG AAAATCTTTGAACGTGGTAGTGTGCAGG	{16754} {16754}
6.087272931341441	18044	18146	102	18044	4	1.0	AGTGGTCGCATTGTGCAAAGCCATATTATG GGCGGTCGCACTGTGCAGAGTCATATTATG GGTGGTCGCACTGTGCAAAGTCATATCATG GGTGGTCGTGTGGTACAGAGTCATATTATG	18116	3	1.0	ATTGGTAATCCTAAAGGTATTCGTTGTGCC ATTGGTAATCCTAAGGGTATTCGTTGTGCT GTGGGTAATCCAAAGGGTATTCGTTGTGCT	2	1.0	CGTGCTGCTATTAAACTGTACAACCCTA GTGCTGCTATTAAGTTGTACAACCCTAA	{18074} {18075}
6.090511090344213	11850	11940	90	11850	5	1.0	AAAGTCAAAGCCACTAAAGCTGAAGGTGAT AAGGTCAAAGCCACCAAAGCTGAGGGTGAT AAGGTCAAGGCCACCAAAGGTGAAGGTGAT AAGGTTAAAGCCACCAAAGCTGAAGGTGAT AAGGTTAAGGCCACTAAAGCTGAAAGCGAT	11910	2	1.0	TACAACAATGAAGGTGGACGTGCATTTATG TACAATAATGAGGGTGGCCGTGCATTTATG	3	1.0	AGGTCTTAGCAGTGAAGGCAATGCCTTA GAGGCATTATTAGTGAAGGTAATGCTCT GGAGGTATTACTAGTGAAGGTAACGCTC	{11882} {11881} {11880}
6.094716028494806	27185	27417	232	27185	2	1.0	TTGGAAAGTGATACCACGTGACTTGGTACC TTGGAAGGTGATACCTCGTAATTTGGTACC	27387	4	1.0	ATCTGGGTCGCTATTGATGGTGCCAAAACC GTCTGGGTTGCAGTTAATGGTGCTAAAACA GTCTGGGTTGCTGTTGATGGTGCTAAAACC GTTTGGGTTGCCATGAATGGTGCCAAAACT	4	1.0	ACAAGAAAGATAAAGACAAGCTTATAGG ACTAACAAGGGTGACAAAGACAAGTTTG CTATTGGAATGTTCAAAAACGTTTCAGA TACTAACAAGAAGGAAAAAGACAAGCTT	{27220} {27216} {27248} {27215}
6.102185705661207	11498	11602	104	11498	2	1.0	GCATAGTTTACTCTTTGGCATGCTCCGACG GCATCGCTTACTCTTTGGCATGCTCCGTAG	11572	5	1.0	ATGGTGTTGTACCCCTCTCTGTTATTCCTG ATGGTGTTGTCCCTCTCTCTGTTATTCCTG ATGGTGTTGTCCCTCTTTCCGTTATCCCTG ATGGTGTTGTTCCTCTTTCTGTTATCCCTG ATGGTGTTGTTCCTCTTTCTGTTATTCCTG	2	1.0	GTGTTGACACTATCCTTAATATGGCACG TCTAGTGTGGACACTATTCTTAACATGG	{11542} {11538}
6.174616373031192	9800	9899	99	9800	3	1.0	AGACCAACCTAACCTTCAAGTTGAATCTGC GGACCAACCTAACCTTCAGGTTGAATCTGC TGACCAACCTAACCTTCAAGTTGAATCTGC	9869	4	1.0	TGCGGCTATATTGAATGGTTGCACCTGGTG TGCTGCCATACTGAATGGTTGTACATGGTG TGCTGCTATATTGAATGGTTGCACATGGTG TGCTGCTATATTGAATGGTTGCATATGGTG	3	1.0	AACCAGATGCTAACAGTCAATGTGGTAG ACCAGATGCTAACAGTTAATGTGGTCGC AGTCAAATGTTAACGACTAATGTTGTAG	{9831} {9832} {9831}
6.190648055426139	9881	9982	101	9881	4	1.0	GAATGGTTGCACATGGTGGCTCAAAGGTGA GAATGGTTGCACATGGTGGCTTAAAGGTGA GAATGGTTGCACCTGGTGGCTTAAAGGCGA GAATGGTTGCATATGGTGGCTCAAAGGTGA	9952	3	1.0	ATGGTTTCACAGCTATGAATGGTGAAGACG ATGGTTTTACAGCCATGAATGGTGAAGATG ATGGTTTTACAGCTATGAATGGCGAAGATG	3	1.0	GTAGAACATTATAATGAGTGGGCACAGG TAGGTTGTCTGTTGAACACTATAATGAA TGTAGAACATTACAATGAATGGGCACAG	{9921} {9911} {9920}
6.206909836406473	11566	11687	121	11566	4	1.0	CACGTAATGGTGTTGTACCCCTCTCTGTTA CACGTAATGGTGTTGTCCCTCTCTCTGTTA CACGTAATGGTGTTGTCCCTCTTTCCGTTA CACGTAATGGTGTTGTTCCTCTTTCTGTTA	11657	3	1.0	AATGATGGTAGATGGTTTTGTGCACTACGC AATGATGGTAGATGGTTTTGTTCACTACGC AATGTTGGTAGATGGTTTTGTGCACTATGC	2	1.0	GTCGTCGTGGTGCCAGATCATGATTCAT GTCGTTGTAGTACCAGATCATGATTCAT	{11622} {11622}
6.2223	8484	8608	124	8484	2	1.0	GACAAGTGGTTTGTTAATGATGGAAGTGTG GACAAGTGGTTTGTTAATGATGGACGTGTT	8578	5	1.0	CATCCTCATTTTCTGTTGCCGCAATGTCAG CATCTTCATTTTCTGTTGCTGCAATGTCAG CATGTTCATTTTCTGTAGCTGCAATGTCAG CATTATCGTTCTCTGTAGCCGCAATGTCAG CGTCCTCATTCTCTATTGCTGCAATGTCAG	2	1.0	TAATGGTTATGTTTGCGGTACAGGTCTG TGGTTATGTTTGTGGTACTGGTTTGTGG	{8516} {8519}
6.2223	9129	9253	124	9129	3	1.0	GCAGATTACCGCTGTGCTTGTTATGCTTAT GCAGATTACCGTTGTGCTTGTTATGCCTAT GCTGATTACCGTTGTGCTTGTTATGCTTAT	9223	4	1.0	TCAGTTATGGGTCTACATTACAAGCAGGTT TCAGTTATGGTTCTACATTACAGGCAGGTT TCAGTTATGGTTCTACATTACAGGCTGGCC TTAGTTATGGTTCGACCTTGCAAGCAGGTT	2	1.0	AGCAATGTTGGACTTTTCGCGTGATCAC GCAAAGGCCATGATGGACTATTCGCGTG	{9167} {9162}
6.2223	12756	12880	124	12756	3	1.0	GTTGCATTAAGTCAGTTATGGACCACGAGC GTTGTATTAAGTCGGTTATGGACCACGAGC GTTGTGTTAAGTCAGTTATGGACCACGAGC	12850	4	1.0	TGAAGGCAGAACCATCTATGGTAACGTTAG TGAAGGCCGAACCATCTATGGTAATGTTAG TGAGGGCAGAACCATCTATGGTAATGTTAG TGAGGGCAGAACCATTTATGGTAATGTTAG	2	1.0	AGTCCATGTATAACTTACTTAAAGGCTG TCGCAAAGCATGATTTCTTTACGTGGCA	{12786} {12822}
6.241734243325825	383	511	128	383	3	1.0	CTATAGCGAGGCCGCTAGCAATGGATTTAG TTATAGCGAGGCCGCTAGCAATGGTTTTAG TTATAGCGAGGCCGCTGTCAATGGTTTTAG	481	4	1.0	TGGGTCTGACCGGCGACCAACCACTGGTTT TGGGTCTGCATGGCAATCAGACGTTGTTTT TGGGTCTGCATGGTAACCAAACGTTGTTCT TGGGTTTGCATGGTAACCAAACGTTGTCCT	2	1.0	AGCATGCCGATTTGTTTCATTTGGCTTG GGCATGCCGATTTGTTTCATTAGATTTG	{413} {413}
6.2477885273624	25275	25384	109	25275	2	1.0	CAAGTGGCCGTGGTGGGTGTGGTTGTGCAT TAAGTGGCCATGGTGGGTGTGGTTGTGTAT	25354	5	1.0	GCCACAGGTTGTTGTGGCTGCTGTAGTTGT GCTACAGGTTGTTGTGGCTGTTGTAGTTGT TCCACTGGTTGTTGCGGCTTCTTTAGTTGT TCTACTGGTTGCTGCGGTTTCTTTAGTTGT TCTACTGGTTGCTGTGGCTTCTTTAGTTGT	3	1.0	GTCATTGTCCTAATTTTTACTGTGGGCT GTCGTGCTCATCTTTGTGGTGAGTATGT TGTGATTGTGTTGATTTTTGTGGTGGGC	{25306} {25309} {25305}
6.25104304098169	20060	20219	159	20060	3	1.0	GATTGCGCAACTGTGTATCTAGAAGACAAG GATTGCGCAGCCGTTTATCTGGAAGACAAA GATTGTGCAACCGTTTATTTGGAAGACAAG	20189	4	1.0	ATTTGCGAAAAACTTGCTATCGGAGGTTCT ATTTGTGAAAAACTTGCCATAGGAGGTTCC ATTTGTGAAAAACTTGCCATCGGAGGTTCA ATTTGTGAGAAACTTGCCATCGGAGGATCG	1	1.0	ATATGTACGATGGCAGGACAAAGGCAAT	{20109}
6.260612910986066	8163	8274	111	8163	3	1.0	GCCTTTGGTAGTGCAGGTGTCTGTTATGAC GCGTTTGGTAATGCTGGTGTGTGTTATGAC GCTTTTGGTAATGCTGGTGTTTGTTATGAC	8244	4	1.0	AGATTAGAAGGTCTGGGTGGTAACAATGTC AGATTAGAGGGTCTTGGTGGTAACAATGTT AGATTGGAAGGTTTGGGTGGTAACAATGTT AGGCTAGAAGGTTTGGGTGGTGATAATGTT	3	1.0	TATTTGGAGTTACTACACCTGAAAAGTG TCTTTGGAGTCACAACACCGGAAAAGTG TGGCGTCACAACACCTGAAAAGTGCATT	{8194} {8194} {8198}
6.26447901698314	9881	10014	133	9881	4	1.0	GAATGGTTGCACATGGTGGCTCAAAGGTGA GAATGGTTGCACATGGTGGCTTAAAGGTGA GAATGGTTGCACCTGGTGGCTTAAAGGCGA GAATGGTTGCATATGGTGGCTCAAAGGTGA	9984	3	1.0	TTCTCCATTCTTGCTGCTAAAACTGGCGTT TTTTCCATTCTTGCTGCTAAAACTGGTGTC TTTTCTATTCTTGCTGCAAAAACCGGTGTC	2	1.0	ACTATAATGAATGGGCACAGTCCAATGG TGTAGAACATTACAATGAATGGGCACAG	{9928} {9920}
6.2818905569654335	15171	15340	169	15171	5	1.0	GAAAGGTGTTTTATGCGCTTTTAGATTGGG GGAAAGTGTTTTATGCACTGTTAGACTGGG GGAAAGTGTTTTATGCACTTTTGGATTGGG GGAAGGTGTTCTATGCATTGTTAGACTGGG GGAAGGTGTTTTACGCATTGTTAGATTGGG	15310	2	1.0	GTATGAAAAGTCTACAGTTCTTCAAGCAGC GTATGAGAAGTCTACAGTACTACAAGCTGC	1	1.0	CAAGAGTCCAAGTTTTGGGATGAAAGCT	{15269}
6.285716373031192	12000	12138	138	12000	4	1.0	GTGGTTACAGTAGAACTGGAACCACCTTGC GTGGTTACAGTTGAATTGGAACCACCTTGC GTGGTTGCAGTGGAATTGGAACCACCTTGC GTTGTTACAGTAGAGTTAGAACCTCCATGT	12108	3	1.0	GGTGCTGTTTTGGGTTACATAGGCGCTACT GGTGCTGTTTTGGGTTACATTGGTGCCACT GGTGCTGTTTTGGGTTATATCGGTGCTACT	2	1.0	GACACACCTACCGGACCCCAAATTAAGT GATTTGTTGTAGACACACCTACTGGACC	{12042} {12031}
6.296268161147406	1208	1382	174	1208	3	1.0	GTTCGTAGCTAGCATTGAGGGCGTTTCTGT GTTTGTTGCAAACATTGAAGGTGTCTCTGT GTTTGTTGCAAGCATTGAATGTGTCGCTGT	1352	4	1.0	AACTGATGAGTGTCGATTGGCCATGTTAGG TACTGATGAGTGTCGTATAGCTATGTTAGG TACTGATGAGTGTCGTTTGGCCATGTTGGG TGTTGATGAGTGTCGTATGGCCATGTTGGG	1	1.0	CAGAATGGATACATTCTGCTTCAATGTA	{1313}
6.305633761645287	10946	11089	143	10946	4	1.0	GGGTATTGGCGGTCCTAGAACTATTAAAGT GGGTATTGGCGGTCCTAGGACCATTAAAGT GGGTATTGGTGGACCTAGAACTATTAAAGT GGGTATTGGTGGTCCTAGAACCATTAAAGT	11059	3	1.0	CTAACACAAAGGAGTGGGCGTATTGTGTTG CTAACTCAAAGGAGTGGGCATATTGTGTTG CTAATTCAAAGGAGTGGGCATATTGTGTTG	2	1.0	ATGGGCATTTTGTCTAATATGAACATAG CGTCGTTTTAATGGGCATTTTATCTAAC	{11028} {11018}
6.317016028494806	17180	17326	146	17180	5	1.0	CCACCAAGTCATGCCACTACTTATTTGTCA CCACCAAGTCATGCTACTACCTATTTATCA CCACCAAGTCATGCTACTACTTATCTATCA CCACCCAGTCATGCCACCACTTATTTATCA CCACCTAGCCATGCCACTACGTATTTGTCA	17296	2	1.0	CATGGGTTTTAGATTTGATGGTAGTTTGCC TATGGGTTTCAGGTTTGATGTTAGTATGCC	2	1.0	GTGGCGATTTGGCTGTCCAAATAGGTGG TGTCTGATAGATTTAAGACTAGTGGTGA	{17232} {17211}
6.338370128054923	17993	18183	190	17993	3	1.0	GACTGGTCAATAACCTACCCTATGATAGCT GACTGGTCAATTACCTATCCTATGATAGCT GATTGGTCAATTACCTACCCTATGATAGCT	18153	4	1.0	ATGCAAAGTGGTATTGTTACGACAAGGACC ATGCCAAATGGTATTGTTACGACAAGGATC ATGCCAAGTGGTACTGTTATGACAAAGACC ATGCCAAGTGGTATTGTTATGACAAGAACC	1	1.0	TCATGCGTGCTGCTATTAAATTGTACAA	{18069}
6.342101087828205	8245	8398	153	8245	4	1.0	GATTAGAAGGTCTGGGTGGTAACAATGTTT GATTAGAGGGTCTTGGTGGTAACAATGTTT GATTGGAAGGTTTGGGTGGTAACAATGTTT GGCTAGAAGGTTTGGGTGGTGATAATGTTT	8368	3	1.0	AATTGCCAGAAGTAATTGCACAGGGTTTTG AATTGCCGGAAATAATTGCACAGGGCTTTG AGTTGCCAGAAGTTATTGCACAAGGCTTTG	2	1.0	TGCCTTACAGTTCAATACAAGCTAACGC TTACCTTACAGTTCTTTGCAAGCTAATG	{8308} {8307}
6.342101087828205	18476	18629	153	18476	4	1.0	CAAGTCAACTATGTTCCTTTGAGAGCCACT CAAGTCAATTATGTTCCTCTTAGGGCTACC CAAGTTAACTATGTTCCTTTGAGAGCCACT CAGGTTAACTATGTTCCTTTGAGGGCCACT	18599	3	1.0	CAAGCTGGCTTTAACATTTGGGTTCCTACC CAAGCTGGTTTTAATATTTGGGTTCCTACC CAGGCTGGTTTCAACATTTGGGTCCCTAAC	2	1.0	TAGAGCATATGTGGAGTCATATAACACT TCCAAACATGCAAACCTATATAGAGCAT	{18565} {18545}
6.343264373321449	5342	5468	126	5342	3	1.0	CGCCACTACATTTGCAACATTAGATCATAG CGCTGTTACTTTTGCAACAGTTGATCATAG TGCTGTAACCTTTGCAACAGTTGATCATAG	5438	4	1.0	TTGGGTGAATGCTGTGTGTATTTCACTACA TTGGGTGAATGCTGTTTGTATTGCACTACA TTGGGTTAATGCTGTGTGCGTTGCATTACA TTGGGTTAATGCTGTTTGTATCTCACTGCA	3	1.0	GAGTGTTAAAAACCAGTGATAATAATTG TCAGAGTTTTGAAAACCAGTGATAATAA TGCGTTTGCATATGAAAGTAGTGTTGTT	{5410} {5407} {5372}
6.345529642842771	9129	9283	154	9129	3	1.0	GCAGATTACCGCTGTGCTTGTTATGCTTAT GCAGATTACCGTTGTGCTTGTTATGCCTAT GCTGATTACCGTTGTGCTTGTTATGCTTAT	9253	4	1.0	TGCGCAAAATGGCACAACCATCTGGCTTTG TGCGTAAAATGGCACAACCATCTGGCATTG TGCGTAAAATGGCACAGCCATCTGGCATTG TGCGTAAAATGGCGCAGCCGTCTGGCATTG	2	1.0	AGCAATGTTGGACTTTTCGCGTGATCAC GCAAAGGCCATGATGGACTATTCGCGTG	{9167} {9162}
6.3480850181197175	7479	7606	127	7479	5	1.0	GCACACCGTTATGATGTGTTGTTATCAGAT GCACATCGTTGTGACGTGTTGTTATCTGAT GCACATCGTTGTGACGTTTTGTTGTCTGAT GCGCATCGTTGTGACGTGTTGTTGTCTGAC GCTCATCGTTGTGATGTGTTGTTGTCTGAC	7576	2	1.0	CTTGTTGTATGCGCGCTGGTGCTAAGACTG CTTGTTGTATGCGTGCAGGTGCTAAGGTTG	3	1.0	ACTTTGTCAGTTCATATGCTAAACCAGA GATGAAAAATTATCAGCTTATGACTTGG TTTGTTAGTTCGTATGCAAAACCTGAGG	{7522} {7548} {7524}
6.35560063353398	11114	11271	157	11114	5	1.0	TGACGACCCTGAAACTGCTCAAGAGTTATT TGACGACCCTGAGACGGCGCAGGAGCTTTT TGACGACCCTGAGTTAGCCCAAGAGCTGCT TGATAACCCCGAAACTGCTCAGGAGCTGTT TGATGACCCTGAAACTGCTCAAGAATTGTT	11241	2	1.0	GTCGCATCATCTTTTGTTGGTATGCCGTCT GTTGCATCGTCTTTTGTTGGTATGCCATCT	2	1.0	TCTTGTCTAAGCATAGTGATTTTGGTCT TTCTTATTTTGAGAACGACTCCATTTTG	{11164} {11207}
6.368554591467449	16663	16824	161	16663	3	1.0	CAGATGTCCTGCTGAAATAGTTAACACTGT CAGGTGTCCAGCTGAAATAGTTAACACTGT CAGGTGTCCTGCTGAAATAGTTAATACTGT	16794	4	1.0	CCAGTATAAACAGGCGCCAACTTGATGTTG CCAGTATAAACCGTCGACAACTTGACGTCG CCAGTATAAATAGACGCCAACTTGATGTTG CCAGTATAAATAGGCGTCAACTTGATGTTG	2	1.0	AAAACAAGTTTGTACCAGTCAAAGATGC AAACAAGTTTGTACCTGTCAAAGAAGCT	{16710} {16711}
6.377937705370951	19084	19248	164	19084	2	1.0	CTCTGCTACTGCTGTGAAAGCAGGTGGTAA CTCTGTTACTGCTGTTAAAACAGGTGGTAA	19218	5	1.0	ACGTACGCAAAGATGGTAAACATGTTGATC ACGTTCGCAAGGATGGCAAGCTTTTGGACC ATGTACGCAAAGATGGCAAACCTGTGGATC ATGTACGCAAAGATGGTAAGCCTGTTGATC ATGTACGCAGAGATGGCAAGCCTGTAGATC	2	1.0	ATTTGCCAGCCATTCGGTTAAATTTTGG TTGCCGGCTATTAAATTGAATTTTGGAA	{19116} {19118}
6.390036002980723	5255	5369	114	5255	4	1.0	TGGTGCAGTACCAAGCGATCTTAATACATC TGGTGCAGTACCCAGTGATCTTAACACATC TGGTGCAGTGCCAAGTGACCTCAACACATC TGGTGCAGTTCCCAGTGATCTTAATACGTC	5339	3	1.0	AGACGCCACTACATTTGCAACATTAGATCA AGACGCTGTTACTTTTGCAACAGTTGATCA AGATGCTGTAACCTTTGCAACAGTTGATCA	4	1.0	GAATTGCTTACTAAAGCTATAGATGTTG GAATTGCTTACTAAGGCAATAGATGTTG GAATTGCTTACTATAGCAATAGATGTTG TAGATGTTGATTGGGTTGAATTTTATGG	{5286} {5286} {5286} {5305}
6.390591578646308	12853	13066	213	12853	4	1.0	AGGCAGAACCATCTATGGTAACGTTAGTAG AGGCCGAACCATCTATGGTAATGTTAGTAG GGGCAGAACCATCTATGGTAATGTTAGTAG GGGCAGAACCATTTATGGTAATGTTAGTAG	13036	3	1.0	AAATGAGGACATACACCGCGTGTACGCTGC AAATGAGGACATACACCGTGTATACGCTGC AAATGAGGACATACACCGTGTGTATGCTGC	1	1.0	CTGATTACTTCGAAATGAAGAATTGGTT	{12996}
6.3926799693424075	19951	20088	137	19951	4	1.0	TGTAGCGCCTGGAACAGCAGTTCTCAAAAG TGTGGCACCAGGAACTGCAGTTCTTAAGCG TGTTGCACCAGGAACTGCCGTTCTTAAAAG TGTTGCACCCGGAACTGCAGTTCTCAAACG	20058	3	1.0	GTGATTGCGCAACTGTGTATCTAGAAGACA GTGATTGCGCAGCCGTTTATCTGGAAGACA GTGATTGTGCAACCGTTTATTTGGAAGACA	3	1.0	CAATTGTGGTTGATAATGATGTTGTAGA CAATTGTTGTTGATAATGATGTTGTTGA GCAATTGTTGTGGATAACGACGCTGTGG	{19998} {19998} {19997}
6.392990556965433	16030	16199	169	16030	4	1.0	TGTTGCGCCACTTAGAGCACCAACCTTGGC TGTTGCTCCACTTAGAGCACCAACAATGGC TGTTGCTCCACTTAGAGCACCAACTATGGC TGTTGCTCCACTTAGAGCGCCAACAATGGC	16169	3	1.0	ACAACAATACAGGGTCCGCCTGGTAGTGGT ACCACAATACAGGGTCCTCCTGGTAGTGGA ACTACAATACAGGGTCCCCCTGGTAGTGGT	2	1.0	CACCCATCATTTAATGTTAGTGATGCTT CCATCGTTTAATGTTAGCGATGCATATG	{16094} {16097}
6.4016942636811995	15124	15296	172	15124	3	1.0	GGCTATAGATGCATACCCATTGTCCAAACA GGCTATAGATGCATACCCATTGTCTAAACA TGCTATAGATGCGTACCCATTGTCCAAACA	15266	4	1.0	GAACAAGAGTCCAAGTTTTGGGATGAAAGC GAACAGGAGTCTAAGTTTTGGGATGAAAAC GAACATGAGTCTAAGTTTTGGGATGAAAGC GACCAAGAGTCTAAGTTTTGGGACGAGAGC	2	1.0	AAAACTCTTAATGAAGGTGTTTTGGAGT TCCTAAACCTGAGTATAGGAAAGTGTTT	{15215} {15154}
6.404543765448655	13063	13236	173	13063	4	1.0	TGCTTTAGGCAAGGTAGTTGCAAATGCAAT TGCTTTGGGTAAAGTAGTCGCAAATGCAAT TGCTTTGGGTAAGGTAGTCGCAAACGCAAT TGCTTTGGGTACAGTAGTCGCAAATGCAAT	13206	3	1.0	TGTGTCCGCCTGGAATGGGAATACCTTATT TGTGTCCTCCTGGAATGGGAATACCCTACT TGTGTCCTCCTGGTATGGGAATACCCTATT	2	1.0	GTGTTGCGCTTTGTGACGAAATGGTTCG GTGTTGCTCTTTGCGACGAAATGGTGCT	{13101} {13101}
6.404932422683973	16544	16684	140	16544	5	1.0	CAACAATTGCCAGCTCCTAGAGTTCTTATC CAACAGCTGCCAGCTCCTAGAGTTCTTATC CAACAGCTTCCAGCCCCTAGGGTGCTTATA CAACAGTTGCCTGCTCCTAGAGTTCTTATC CAGCAGCTTCCAGCTCCTAGAGTTCTTATC	16654	2	1.0	CAAATGTTACAGGTGTCCAGCTGAAATAGT CAAGTGTTACAGATGTCCTGCTGAAATAGT	3	1.0	AATCGATTATAATGTTGTGACACAGCGT AATTGACTATAATGTTGTGACACAACGT TCCAAAGGAACTATGGAACCAGTAGATT	{16594} {16594} {16574}
6.407368161147406	12000	12174	174	12000	4	1.0	GTGGTTACAGTAGAACTGGAACCACCTTGC GTGGTTACAGTTGAATTGGAACCACCTTGC GTGGTTGCAGTGGAATTGGAACCACCTTGC GTTGTTACAGTAGAGTTAGAACCTCCATGT	12144	3	1.0	CTGCAGGCTGGTAAACAAACTGAGTTTGTT TTGCAAGCTGGCAAACAGACTGAGTTCGTT TTGCAAGCTGGTAAACAGACTGAGTTTGTT	2	1.0	AGGTTTGTAGTCGATACACCTAATGGAC ATCTTAACAATTTAAGGAGAGGTGCTGT	{12030} {12088}
6.410887395870146	6466	6689	223	6466	4	1.0	GCGGTAATTCATTGGGCTGTAAGATGTGTC GTGAAGGTTCACTAGGTTGTAAAATGTGTC GTGATGGTTCATTGGGCTGCAAGATGTGTC GTGATGGTTCATTGGGCTGTAAAATGTGTC	6659	3	1.0	GATGATAAGCAATGTAGGCGTTTTCTTGGG GATGATAAGCACAGTTGGTGTTTTTCTAGG GATGATAAGCACTGTTGGTGTTTTTCTGGG	1	1.0	ACAATTATCTGAGATGCTTCTTGCTGTA	{6619}
6.412848055426139	13098	13240	142	13098	3	1.0	AATGTGTTGCGCTTTGTGACGAAATGGTTC AGTGTGTTGCTCTTTGCGACGAAATGGTGC AGTGTGTTGCTTTTTGCGATGAAATGGTGC	13210	4	1.0	TCCGCCTGGAATGGGAATACCTTATTGTAC TCCTCCTGGAATGGGAATACCCTACTGCAC TCCTCCTGGAATGGGAATACCTTATTGCAC TCCTCCTGGTATGGGAATACCCTATTGCAC	3	1.0	AGAGGAGTTGTTGGTGTTTTGACCTTAG GCAAGGGCGTTGTTGGTGTTTTGACCCT TCTATGACTTTGGGGATTTCGTTTTGTG	{13130} {13128} {13182}
