cost	target-start	target-end	target-length	left-primer-start	left-primer-num-primers	left-primer-frac-bound	left-primer-target-sequences	right-primer-start	right-primer-num-primers	right-primer-frac-bound	right-primer-target-sequences	num-guides	total-frac-bound-by-guides	guide-target-sequences	guide-target-sequence-positions
2.5126942636811997	489	577	88	489	1	1.0	AGCCGTAAAGTCCGGTACGGCAATTTTAAT	547	1	1.0	TTTCCTAAAGGGTATGTTATGGGCTTGTTC	1	1.0	TAAATCACCTTTGCATAGCTTGGGTGGT	{519}
2.5126942636811997	973	1061	88	973	1	1.0	CAAAAGCAGTCTGTATGGCTTGCCAATTGT	1031	1	1.0	TAGTTCGTGATTCACGATTTGTTATGCGCC	1	1.0	GACTTTGATATTGTAGTGGCTTGGCATG	{1003}
2.5126942636811997	1040	1128	88	1040	1	1.0	ATTCACGATTTGTTATGCGCCTGCAGACTA	1098	1	1.0	TGCACAACCTACAGAAGATGTAGTAGATGG	1	1.0	TAGCTACTATTTGTGGTATTAAATATGT	{1070}
2.5126942636811997	1322	1410	88	1322	1	1.0	ATGGTTGGGTTTCAGGTAATATGATGGATG	1380	1	1.0	TTATGACTCTAGCGAAGTTAAAGCCCAATC	1	1.0	GTTTTTCTTGTCCATTGTGTTGTACAGT	{1352}
2.5126942636811997	2594	2682	88	2594	1	1.0	TTTGTCTTTTAGATCAGGCTTGGCGTTTTC	2652	1	1.0	CGAGAAACCTGTTGTTATGGAGATTCCGTC	1	1.0	CATGTGCAGGTAGAAAAGTTAATTTTAA	{2624}
2.5126942636811997	2905	2993	88	2905	1	1.0	TTATTTGATGAGGCTGGTGATGAAGCAATG	2963	1	1.0	TTGAGGATGTTGAAGACGTTATCAGTAGTG	1	1.0	GCCTCTCGTATGTATTGTACTTTTGCTA	{2935}
2.5126942636811997	4579	4667	88	4579	1	1.0	GACATAATATGACTCTAATAGCAGCGGACT	4637	1	1.0	TGATGACAATTTTTGTGCTTTTTGCACCCC	1	1.0	TACCTTGTACATTACATTTTTCATTATT	{4609}
2.5126942636811997	8840	8928	88	8840	1	1.0	TAACATTGCTCATGCTTCTCTTAGAGAGGG	8898	1	1.0	TTTGTGGGATGTGTACGTAAATGTTGTTCC	1	1.0	TGTGCAATTAGAAAAGGTTTTAGATACT	{8870}
2.5126942636811997	9496	9584	88	9496	1	1.0	TTGATCAATGGTATGAGTCCACTTTTGGGT	9554	1	1.0	CCCTATTGTAGTGGCAGTTATGGATGAAGA	1	1.0	CTTTTTACTATCATAATTCTATGGATTG	{9526}
2.5126942636811997	9907	9995	88	9907	1	1.0	GTGAAGGTATTGTACGTATTGTAAGAACGC	9965	1	1.0	ATGTGAATACGCCGAAGAGGGTATATGTTT	1	1.0	GCTCTATGACTTATTGTAGAGTGGGTGC	{9937}
2.5126942636811997	11276	11364	88	11276	1	1.0	AGAGCTCAGTACTGGTTGTCACACTGGCAC	11334	1	1.0	TATAGAGATGCTCAAGTTGTACAGTTGCCA	1	1.0	TGATTTTACTGGTAATTTTTATGGTCCA	{11306}
2.5126942636811997	11472	11560	88	11472	1	1.0	AATGTTTGGGCTATGGCAAATGGTTTTAGC	11530	1	1.0	CTTTGGCTTCAATGACAGGTGTTTCTATTG	1	1.0	CAAGTAAAAGCAGATCTTGTTTTAGATG	{11502}
2.5126942636811997	29458	29546	88	29458	1	1.0	GATTTTGCCTCAAGGCTATTATGTTGAAGG	29516	1	1.0	CCAGGTTCACGTTCTCAATCACGTGGACCC	1	1.0	CTCAGGAAGGTCTGCTTCTAATAGCCGG	{29488}
2.5239433771173467	2541	2630	89	2541	1	1.0	CATGGGTAAGTGTGGTGATAAATTTTTCCC	2600	1	1.0	TTTTAGATCAGGCTTGGCGTTTTCCATGTG	1	1.0	ATTGTCATGAATGATAAAAATATTTGTC	{2572}
2.5239433771173467	8900	8989	89	8900	1	1.0	TGTGGGATGTGTACGTAAATGTTGTTCCAT	8959	1	1.0	CTAAATCTATGATATCTGCAGTAGCTGCTG	1	1.0	TGATTCAGATGTTGAAACAAGATTTATT	{8930}
2.5239433771173467	9781	9870	89	9781	1	1.0	CACCACATCCTTATTGTTATTCAGATGGTG	9840	1	1.0	TTGGTTCCACATACACGTTATAGCCTTGCT	1	1.0	TATGAAGAATGCTTCTTTGTATACATCT	{9812}
2.5239433771173467	28918	29007	89	28918	1	1.0	TAGGATGTCTTATACTCCCGGTCATTATGC	28977	1	1.0	CAGGAATCCTCAAGAAAACTTCTTGGGCTG	1	1.0	TGGAAGTAGAAGCTCCTCTGGAAATCGT	{28948}
2.534811090344213	2769	2859	90	2769	1	1.0	GGGTGTTACTGTAGATGATTTTGTTGCTGT	2829	1	1.0	CTCTTGTAAAGAGCATCCAGTGGTTGGTTA	1	1.0	TTTGTGATGCTATAGAGAATGCTTTAAA	{2801}
2.565364373321448	29537	29630	93	29537	1	1.0	CGTGGACCCAATAATCGTTCATTAAGTAGA	29600	1	1.0	GTAAAACCTGATATGGCTGATGAGATTGCT	1	1.0	AATTCTAATTTTAGACATTCAGATTCTA	{29570}
2.5749342433258255	1730	1824	94	1730	1	1.0	GTAGGCAACTGTTGCTTAATAGAGGTGATT	1794	1	1.0	TAAGCGTCGTGCTGATTTTGCTTGCAAGTT	1	1.0	TAATATGCTTCTAAAAAATATTGACTTG	{1761}
2.5842266863651715	1257	1352	95	1257	1	1.0	GTGTGATTGTGGTTTTGTTATGCAGTATGG	1322	1	1.0	ATGGTTGGGTTTCAGGTAATATGATGGATG	1	1.0	TGTAGATTGTTTTAATGATAATTGTGAT	{1290}
2.6020405378427527	4638	4735	97	4638	1	1.0	GATGACAATTTTTGTGCTTTTTGCACCCCT	4705	1	1.0	ACGTTTGTCATTCTGTAGCTGTTATAGGTG	1	1.0	TTTTATTGCTGCATGTGCTGTGGATGTA	{4676}
2.6105894934871645	2343	2441	98	2343	1	1.0	CGTTAGTACAGGGTTAATTCCTGGTTTTGT	2411	1	1.0	TTGAAGGCGTTGCAGAATCTGTTATAGTAG	1	1.0	TTTACCATGTAATGCACAGGAACAACAA	{2373}
2.6105894934871645	2933	3031	98	2933	1	1.0	TGGCCTCTCGTATGTATTGTACTTTTGCTA	3001	1	1.0	GAAGATACTATTGATGGTGTCGTTGAAGAC	1	1.0	TTGAGGATGTTGAAGACGTTGTCAGTAG	{2963}
2.6237942636811997	11511	11599	88	11511	1	1.0	GCAGATCTTGTTTTAGATGCTTTGGCTTCA	11569	1	1.0	TGGCTGCTATTAAGCGTCTATATATGGGAT	2	1.0	ATGACAGGTGTTTCCATTGAAACTTTAT ATGACAGGTGTTTCTATTGAAACTTTAT	{11541} {11541}
2.6502160284948064	6910	7013	103	6910	1	1.0	CTGGTGATGTTGTTTTGGCATCTGATGATT	6983	1	1.0	GCCTGTTATTTGGTTTTGTCATGATGAAGC	1	1.0	ATGTGAAACGTTATTTTAAAGGATGTGA	{6943}
2.678729642842771	1795	1902	107	1795	1	1.0	AAGCGTCGTGCTGATTTTGCTTGCAAGTTT	1872	1	1.0	TCCCCGTAGTTATTATCTAATTCAGAGTGG	1	1.0	GCAGTTTGTGGAGATGGTTTTGTACCTT	{1825}
2.685478667660241	4599	4707	108	4599	1	1.0	GCAGCGGACTTACCTTGTACATTACATTTT	4677	1	1.0	TTTATTGCTGCATGTGCTGTGGATGTAAAC	1	1.0	TCATTATTTGATGACAATTTTTGTGCTT	{4629}
2.6920885273623996	9273	9382	109	9273	1	1.0	CCCTTTTCACTTAAAGGAGGTGTTGTATTG	9352	1	1.0	TATTGTGGGCTTTACTGCCTACATATAGTG	1	1.0	AGTAATTTGTTATATATATTATTTTTTA	{9303}
2.6985648453679434	9846	9956	110	9846	1	1.0	CCACATACACGTTATAGCCTTGCTAATTCT	9926	1	1.0	TGTAAGAACGCGCTCTATGACTTATTGTAG	1	1.0	GTTTTATAAGATTTCCTGATGTTATTAG	{9880}
2.704912910986066	9676	9787	111	9676	1	1.0	GTGTTCAGTGCTATACACCACATATTCAGA	9757	1	1.0	CTATGTTTAAAAGAGGTGATGGTACACCAC	1	1.0	TGCTAGTGGTTGTGTTTTATCATCTTTG	{9725}
2.7172439250039426	804	917	113	804	1	1.0	GGTTCATGCTGAGCCTAAAGGTAAATATTC	887	1	1.0	TTGTAGACCAGTATGGTTGTGACTATTCTG	1	1.0	TAGACAATATCGTGGTATTAAACCCGTA	{855}
2.7172439250039426	2846	2959	113	2846	1	1.0	CAGTGGTTGGTTATCAAGTTCGTGCATTTT	2929	1	1.0	GCAATGGCCTCTCGTATGTATTGTACTTTT	1	1.0	TAAACTTAATGAGAATGTTGTTTATTTA	{2880}
2.7381324226839716	28983	29083	100	28983	1	1.0	TCCTCAAGAAAACTTCTTGGGCTGACCAAT	29053	1	1.0	CCAACCTAAATTCACTGTGTCTACTCAACC	2	1.0	ATCAAACCTATAATAGAGGCAGAAAACC CTGAGCGAAATTACCAAACCTTTAATAG	{29025} {29013}
2.7405681611474058	569	686	117	569	1	1.0	GCTTGTTCCGTTCATACAAGACTAAACGTT	656	1	1.0	TGGGTTGGATTGTACCTTTTGGTTTTATGC	1	1.0	ATGTTGTACATCATCTTTCTATGACTAC	{599}
2.7405681611474058	892	1009	117	892	1	1.0	GACCAGTATGGTTGTGACTATTCTGGTAAA	979	1	1.0	CAGTCTGTATGGCTTGCCAATTGTGACTTT	1	1.0	TTAGCAGATTGTCTTCAAGCTTATGGTC	{922}
2.751623285568201	6983	7102	119	6983	1	1.0	GCCTGTTATTTGGTTTTGTCATGATGAAGC	7072	1	1.0	GTGTTTTGTCTGTTGATTCTGTATCTGAGG	1	1.0	ATCATTGAATTCTCTTACTTATTTTAAT	{7013}
2.7675224201679636	11284	11406	122	11284	1	1.0	GTACTGGTTGTCACACTGGCACTGATTTTA	11376	1	1.0	GTCCAGACTGTTAATGTTATTGCTTGGCTC	1	1.0	CTGGTAATTTTTATGGTCCATATAGAGA	{11314}
2.7777	1409	1533	124	1409	1	1.0	CATCTGGTGTTATTCCTGAAAATCCTGTGT	1503	1	1.0	ACCATTTGGTTCTTGTATATATTGGTCGCC	1	1.0	TTAACCATGATTCTTTTAATTTGTATGG	{1463}
2.7777	1730	1854	124	1730	1	1.0	GTAGGCAACTGTTGCTTAATAGAGGTGATT	1824	1	1.0	TGCAGTTTGTGGAGATGGTTTTGTACCTTT	1	1.0	TAATATGCTTCTAAAAAATATTGACTTG	{1761}
2.7777	11391	11515	124	11391	1	1.0	GTTATTGCTTGGCTCTATGCAGCTATACTT	11485	1	1.0	TGGCAAATGGTTTTAGCCAAGTAAAAGCAG	1	1.0	GTGCTTGGTTTGTACAAAATGATGTTTG	{11428}
2.7875643733214486	8637	8763	126	8637	1	1.0	GAGAGTGATGCTGATAGAGCTAATTTTCTG	8733	1	1.0	ACTACAGCTTGTAATGGTATCTCTGTAACC	1	1.0	TGTGTTTTATGCACAATCATTGTATAGG	{8675}
2.792385018119717	2671	2798	127	2671	1	1.0	GAGATTCCGTCTTTGATGACAGTTAAGGTT	2768	1	1.0	AGGGTGTTACTGTAGATGATTTTGTTGCTG	1	1.0	ATGTTTGATTTAGATTCTACTTTTGATG	{2701}
2.801814134296109	20896	21025	129	20896	1	1.0	CCCACAAGGTAATCTAGGTGGTAATTGCGC	20995	1	1.0	TTTTGAACCTCGCTCAGATTTAGAACGGGA	1	1.0	CGCGTTTTACTATCTTTACTCAGAGTCG	{20955}
2.801814134296109	29759	29888	129	29759	1	1.0	GTTCAACAGTGTTTTGGTAAAAGAGGACCT	29858	1	1.0	GAATTAGCTCCTACACCAGGTGCTTTTTTC	1	1.0	TGGTAATGCTGAAATGTTAAAGCTTGGT	{29800}
2.8154573353204815	5545	5677	132	5545	1	1.0	CTAGTCTTCCTAAAGATTGGCGTCTTATCA	5647	1	1.0	GTCAGGGTAAAGACTTTGGTTATGTATGTG	1	1.0	TGTTAAGTATTTTGAGTGTCCTAATTCT	{5606}
2.8285435130281846	29537	29672	135	29537	1	1.0	CGTGGACCCAATAATCGTTCATTAAGTAGA	29642	1	1.0	GCCAAGCTTGGTAAAGATTCTAAACCTCAG	1	1.0	AATTCTAATTTTAGACATTCAGATTCTA	{29570}
2.8327894934871645	1257	1393	136	1257	1	1.0	GTGTGATTGTGGTTTTGTTATGCAGTATGG	1363	1	1.0	CCATTGTGTTGTACAGTTTATGACTCTAGC	1	1.0	TGTAGATTGTTTTAATGATAATTGTGAT	{1290}
2.8327894934871645	9389	9525	136	9389	1	1.0	GTCTGATATTCATTTGCCTGCTTATGCTAG	9495	1	1.0	TTTGATCAATGGTATGAGTCCACTTTTGGG	1	1.0	GATAATGGTGTTGTTAGAGATATTTCAG	{9432}
2.836979969342407	8749	8886	137	8749	1	1.0	GTATCTCTGTAACCCAGACTATGTTTGATG	8856	1	1.0	TCTCTTAGAGAGGGTGTGCAATTAGAAAAG	1	1.0	TTTATGTTGATACTTTTATGTCTCATTT	{8779}
2.8411163730311917	2541	2679	138	2541	1	1.0	CATGGGTAAGTGTGGTGATAAATTTTTCCC	2649	1	1.0	TAACGAGAAACCTGTTGTTATGGAGATTCC	1	1.0	ATTGTCATGAATGATAAAAATATTTGTC	{2572}
2.849232422683972	8979	9119	140	8979	1	1.0	GTAGCTGCTGGTTTGGAATTTACTGATGAA	9089	1	1.0	TGCTAAGCATGTACAGGGTAATGTTGCTAA	1	1.0	CAGATTTAGGTGTTCTTATACAGAATGG	{9061}
2.849232422683972	9846	9986	140	9846	1	1.0	CCACATACACGTTATAGCCTTGCTAATTCT	9956	1	1.0	AGTGGGTGCATGTGAATACGCCGAAGAGGG	1	1.0	GTTTTATAAGATTTCCTGATGTTATTAG	{9880}
2.8532146706409636	28983	29124	141	28983	1	1.0	TCCTCAAGAAAACTTCTTGGGCTGACCAAT	29094	1	1.0	CTATCCCACATTATTCCTGGTTCTCCGGGA	1	1.0	ATAGAGGCAGAAAACCCCAACCCAAATT	{29037}
2.8571480554261384	4599	4741	142	4599	1	1.0	GCAGCGGACTTACCTTGTACATTACATTTT	4711	1	1.0	GTCATTCTGTAGCTGTTATAGGTGATGAAC	1	1.0	TCATTATTTGATGACAATTTTTGTGCTT	{4629}
2.8571480554261384	9545	9687	142	9545	1	1.0	TATGGATTGCCCTATTGTAGTGGCAGTTAT	9657	1	1.0	TATGCATTTGCTAGTGATAGTGTTCAGTGC	1	1.0	GGATGAAGATATCGGTTCTACTATGTTT	{9575}
2.8610337616452868	2846	2989	143	2846	1	1.0	CAGTGGTTGGTTATCAAGTTCGTGCATTTT	2959	1	1.0	GCTATTGAGGATGTTGAAGACGTTATCAGT	1	1.0	TAAACTTAATGAGAATGTTGTTTATTTA	{2880}
2.8610337616452868	9921	10064	143	9921	1	1.0	CGTATTGTAAGAACGCGCTCTATGACTTAT	10034	1	1.0	TAGAAGTATGCCTGGAACTTTTTGTGGTAG	1	1.0	GTAGAGTGGGTGCATGTGAATACGCCGA	{9952}
2.8610337616452868	29607	29750	143	29607	1	1.0	CTGATATGGCTGATGAGATTGCTAATCTTG	29720	1	1.0	AAACCTCGCCAAAAGCGAACTCCTAATAAA	1	1.0	CAAGCTTGGTAAAGATTCTAAACCTCAG	{29644}
2.8724160284948064	9273	9419	146	9273	1	1.0	CCCTTTTCACTTAAAGGAGGTGTTGTATTG	9389	1	1.0	GTCTGATATTCATTTGCCTGCTTATGCTAG	1	1.0	AGTAATTTGTTATATATATTATTTTTTA	{9303}
2.876122044777587	892	1039	147	892	1	1.0	GACCAGTATGGTTGTGACTATTCTGGTAAA	1009	1	1.0	GATATTGTAGTGGCTTGGCATGTAGTTCGT	1	1.0	TTAGCAGATTGTCTTCAAGCTTATGGTC	{922}
2.8905319690521503	658	809	151	658	1	1.0	GGTTGGATTGTACCTTTTGGTTTTATGCCA	779	1	1.0	TTAGTGTAGAAGATGCTTATGCTGAGGTTC	1	1.0	CTTATGTTCACAAATGGTTTCAATTCTG	{689}
2.8940354666358683	6983	7135	152	6983	1	1.0	GCCTGTTATTTGGTTTTGTCATGATGAAGC	7105	1	1.0	CACAAGGTAATGTGGTTACTTCTGTTATGG	1	1.0	ATCATTGAATTCTCTTACTTATTTTAAT	{7013}
2.900929642842771	1409	1563	154	1409	1	1.0	CATCTGGTGTTATTCCTGAAAATCCTGTGT	1533	1	1.0	GCGTCCTGGATTGTGGATTCCTATAATTAA	1	1.0	TTAACCATGATTCTTTTAATTTGTATGG	{1463}
2.900929642842771	2417	2571	154	2417	1	1.0	GCGTTGCAGAATCTGTTATAGTAGAAGATG	2541	1	1.0	CATGGGTAAGTGTGGTGATAAATTTTTCCC	1	1.0	ATGTTATTGAGAATGTCAAATCTTCTTT	{2447}
2.9142885273623995	11391	11549	158	11391	1	1.0	GTTATTGCTTGGCTCTATGCAGCTATACTT	11519	1	1.0	TGTTTTAGATGCTTTGGCTTCAATGACAGG	1	1.0	GTGCTTGGTTTGTACAAAATGATGTTTG	{11428}
2.923954591467449	1126	1287	161	1126	1	1.0	GGAGATGTAGTTATACGTGAACCTGTACAT	1257	1	1.0	GTGTGATTGTGGTTTTGTTATGCAGTATGG	1	1.0	TTATTATCTGCTGATGCAATAGTTTTAA	{1156}
2.927112910986066	19523	19685	162	19523	1	1.0	AATGTACATAAAGGTGCACATGTTGCGTCA	19655	1	1.0	AATACATCTTGTAGGTTATTGCAGCGTGTC	1	1.0	ATTGGAATTTAGATTATCCAATAATTTC	{19611}
2.939443925003943	9104	9270	166	9104	1	1.0	GGGTAATGTTGCTAAGGCAGCTAATATTTC	9240	1	1.0	AAGCAAGAGGCAAGTGTCCCTATTCTTACA	1	1.0	TGTGTTAAAACTGGCTTGAAGTTAAAAT	{9201}
2.9424539643783345	29721	29888	167	29721	1	1.0	AACCTCGCCAAAAGCGAACTCCTAATAAAC	29858	1	1.0	GAATTAGCTCCTACACCAGGTGCTTTTTTC	1	1.0	TTTGTAATGTTCAACAGTGTTTTGGTAA	{29751}
2.9454360029807227	1257	1425	168	1257	1	1.0	GTGTGATTGTGGTTTTGTTATGCAGTATGG	1395	1	1.0	AGTTAAAGCCCAATCATCTGGTGTTATTCC	1	1.0	TGTAGATTGTTTTAATGATAATTGTGAT	{1290}
2.948390556965433	9356	9525	169	9356	1	1.0	GTGGGCTTTACTGCCTACATATAGTGTTTA	9495	1	1.0	TTTGATCAATGGTATGAGTCCACTTTTGGG	1	1.0	AAGTCTGATATTCATTTGCCTGCTTATG	{9387}
2.948390556965433	11346	11515	169	11346	1	1.0	CAAGTTGTACAGTTGCCAGTTAAGGACTAT	11485	1	1.0	TGGCAAATGGTTTTAGCCAAGTAAAAGCAG	1	1.0	GTCCAGACTGTTAATGTTATTGCTTGGC	{11376}
2.9570942636811997	1730	1902	172	1730	1	1.0	GTAGGCAACTGTTGCTTAATAGAGGTGATT	1872	1	1.0	TCCCCGTAGTTATTATCTAATTCAGAGTGG	1	1.0	TAATATGCTTCTAAAAAATATTGACTTG	{1761}
2.9710950406914325	892	1069	177	892	1	1.0	GACCAGTATGGTTGTGACTATTCTGGTAAA	1039	1	1.0	GATTCACGATTTGTTATGCGCCTGCAGACT	1	1.0	TTAGCAGATTGTCTTCAAGCTTATGGTC	{922}
2.9710950406914325	9781	9958	177	9781	1	1.0	CACCACATCCTTATTGTTATTCAGATGGTG	9928	1	1.0	TAAGAACGCGCTCTATGACTTATTGTAGAG	1	1.0	TATGAAGAATGCTTCTTTGTATACATCT	{9812}
2.9765285070070253	8749	8928	179	8749	1	1.0	GTATCTCTGTAACCCAGACTATGTTTGATG	8898	1	1.0	TTTGTGGGATGTGTACGTAAATGTTGTTCC	1	1.0	TTTATGTTGATACTTTTATGTCTCATTT	{8779}
2.979211090344213	2671	2851	180	2671	1	1.0	GAGATTCCGTCTTTGATGACAGTTAAGGTT	2821	1	1.0	GCTTTAAACTCTTGTAAAGAGCATCCAGTG	1	1.0	ATGTTTGATTTAGATTCTACTTTTGATG	{2701}
2.979211090344213	9389	9569	180	9389	1	1.0	GTCTGATATTCATTTGCCTGCTTATGCTAG	9539	1	1.0	TAATTCTATGGATTGCCCTATTGTAGTGGC	1	1.0	GATAATGGTGTTGTTAGAGATATTTCAG	{9432}
2.9818714113224147	8903	9084	181	8903	1	1.0	GGGATGTGTACGTAAATGTTGTTCCATTGA	9054	1	1.0	GTAGCTGCTGATTTAGGTGTTCTTATACAG	1	1.0	AAACAAGATTTATTACTAAATCTATGAT	{8944}
2.9818714113224147	29607	29788	181	29607	1	1.0	CTGATATGGCTGATGAGATTGCTAATCTTG	29758	1	1.0	TGTTCAACAGTGTTTTGGTAAAAGAGGACC	1	1.0	CAAGCTTGGTAAAGATTCTAAACCTCAG	{29644}
2.992297268051916	2846	3031	185	2846	1	1.0	CAGTGGTTGGTTATCAAGTTCGTGCATTTT	3001	1	1.0	GAAGATACTATTGATGGTGTCGTTGAAGAC	1	1.0	TAAACTTAATGAGAATGTTGTTTATTTA	{2880}
2.9999	9676	9864	188	9676	1	1.0	GTGTTCAGTGCTATACACCACATATTCAGA	9834	1	1.0	ACATCTTTGGTTCCACATACACGTTATAGC	1	1.0	TGCTAGTGGTTGTGTTTTATCATCTTTG	{9725}
3.0073265909416214	7118	7309	191	7118	1	1.0	GGTTACTTCTGTTATGGAATCGCAGATTAG	7279	1	1.0	TGACAGGTTGTGATTATGTTGTTTGGGTTG	1	1.0	AGAAAGACTGTTAAAATAGAAGATGCTA	{7176}
3.0193342433258255	9104	9300	196	9104	1	1.0	GGGTAATGTTGCTAAGGCAGCTAATATTTC	9270	1	1.0	ACACCCTTTTCACTTAAAGGAGGTGTTGTA	1	1.0	TGTGTTAAAACTGGCTTGAAGTTAAAAT	{9201}
3.0216827288338286	804	1001	197	804	1	1.0	GGTTCATGCTGAGCCTAAAGGTAAATATTC	971	1	1.0	GACAAAAGCAGTCTGTATGGCTTGCCAATT	1	1.0	TAGACAATATCGTGGTATTAAACCCGTA	{855}
3.035423411032158	11346	11549	203	11346	1	1.0	CAAGTTGTACAGTTGCCAGTTAAGGACTAT	11519	1	1.0	TGTTTTAGATGCTTTGGCTTCAATGACAGG	1	1.0	GTCCAGACTGTTAATGTTATTGCTTGGC	{11376}
3.04207901698314	11391	11597	206	11391	1	1.0	GTTATTGCTTGGCTCTATGCAGCTATACTT	11567	1	1.0	ATTGGCTGCTATTAAGCGTCTATATATGGG	1	1.0	GTGCTTGGTTTGTACAAAATGATGTTTG	{11428}
3.04426719502264	2417	2624	207	2417	1	1.0	GCGTTGCAGAATCTGTTATAGTAGAAGATG	2594	1	1.0	TTTGTCTTTTAGATCAGGCTTGGCGTTTTC	1	1.0	ATGTTATTGAGAATGTCAAATCTTCTTT	{2447}
3.04426719502264	2616	2823	207	2616	1	1.0	GCGTTTTCCATGTGCAGGTAGAAAAGTTAA	2793	1	1.0	TGCTGTTGTTTGTGATGCTATAGAGAATGC	1	1.0	TTAACGAGAAACCTGTTGTTATGGAGAT	{2648}
3.04426719502264	9781	9988	207	9781	1	1.0	CACCACATCCTTATTGTTATTCAGATGGTG	9958	1	1.0	TGGGTGCATGTGAATACGCCGAAGAGGGTA	1	1.0	TATGAAGAATGCTTCTTTGTATACATCT	{9812}
3.0464405378427526	2363	2571	208	2363	1	1.0	CTGGTTTTGTTTTACCATGTAATGCACAGG	2541	1	1.0	CATGGGTAAGTGTGGTGATAAATTTTTCCC	1	1.0	AACAACAAATTTATTTTTTTGAAGGCGT	{2393}
3.048599245246692	6910	7119	209	6910	1	1.0	CTGGTGATGTTGTTTTGGCATCTGATGATT	7089	1	1.0	TCTGTATCTGAGGAGTCACAAGGTAATGTG	1	1.0	ATGTGAAACGTTATTTTAAAGGATGTGA	{6943}
3.0507435130281846	19475	19685	210	19475	1	1.0	CAGTGGGGTTATACAGGTTCTTTAACTAGT	19655	1	1.0	AATACATCTTGTAGGTTATTGCAGCGTGTC	1	1.0	ATTGGAATTTAGATTATCCAATAATTTC	{19611}
3.0528735330780323	8903	9114	211	8903	1	1.0	GGGATGTGTACGTAAATGTTGTTCCATTGA	9084	1	1.0	AATGGTGCTAAGCATGTACAGGGTAATGTT	1	1.0	AAACAAGATTTATTACTAAATCTATGAT	{8944}
3.057091578646307	9356	9569	213	9356	1	1.0	GTGGGCTTTACTGCCTACATATAGTGTTTA	9539	1	1.0	TAATTCTATGGATTGCCCTATTGTAGTGGC	1	1.0	AAGTCTGATATTCATTTGCCTGCTTATG	{9387}
3.057091578646307	29537	29750	213	29537	1	1.0	CGTGGACCCAATAATCGTTCATTAAGTAGA	29720	1	1.0	AAACCTCGCCAAAAGCGAACTCCTAATAAA	1	1.0	AATTCTAATTTTAGACATTCAGATTCTA	{29570}
3.0674000822449523	9846	10064	218	9846	1	1.0	CCACATACACGTTATAGCCTTGCTAATTCT	10034	1	1.0	TAGAAGTATGCCTGGAACTTTTTGTGGTAG	1	1.0	GTTTTATAAGATTTCCTGATGTTATTAG	{9880}
3.0674000822449523	11284	11502	218	11284	1	1.0	GTACTGGTTGTCACACTGGCACTGATTTTA	11472	1	1.0	AATGTTTGGGCTATGGCAAATGGTTTTAGC	1	1.0	CTGGTAATTTTTATGGTCCATATAGAGA	{11314}
3.069422592664184	1533	1752	219	1533	1	1.0	GCGTCCTGGATTGTGGATTCCTATAATTAA	1722	1	1.0	TTCTTGGTGTAGGCAACTGTTGCTTAATAG	1	1.0	TATGATGATTTGGTTTATTCAGGTGTAG	{1579}
3.071432422683972	9567	9787	220	9567	1	1.0	GCAGTTATGGATGAAGATATCGGTTCTACT	9757	1	1.0	CTATGTTTAAAAGAGGTGATGGTACACCAC	1	1.0	TTAACTTATGCATTTGCTAGTGATAGTG	{9651}
3.0812967960054203	7118	7343	225	7118	1	1.0	GGTTACTTCTGTTATGGAATCGCAGATTAG	7313	1	1.0	TGAATTGTCACGCCTAGTTAAATCACCAAC	1	1.0	AGAAAGACTGTTAAAATAGAAGATGCTA	{7176}
3.0832337616452867	1126	1352	226	1126	1	1.0	GGAGATGTAGTTATACGTGAACCTGTACAT	1322	1	1.0	ATGGTTGGGTTTCAGGTAATATGATGGATG	1	1.0	TTATTATCTGCTGATGCAATAGTTTTAA	{1156}
3.0851590937877345	804	1031	227	804	1	1.0	GGTTCATGCTGAGCCTAAAGGTAAATATTC	1001	1	1.0	GTGACTTTGATATTGTAGTGGCTTGGCATG	1	1.0	TAGACAATATCGTGGTATTAAACCCGTA	{855}
3.087072931341441	1059	1287	228	1059	1	1.0	CCTGCAGACTATAGCTACTATTTGTGGTAT	1257	1	1.0	GTGTGATTGTGGTTTTGTTATGCAGTATGG	1	1.0	GTTGCACAACCTACAGAAGATGTAGTAG	{1096}
3.0927468288076465	8637	8868	231	8637	1	1.0	GAGAGTGATGCTGATAGAGCTAATTTTCTG	8838	1	1.0	GTTAACATTGCTCATGCTTCTCTTAGAGAG	1	1.0	TGTGTTTTATGCACAATCATTGTATAGG	{8675}
3.0946160284948063	892	1124	232	892	1	1.0	GACCAGTATGGTTGTGACTATTCTGGTAAA	1094	1	1.0	ATGTTGCACAACCTACAGAAGATGTAGTAG	1	1.0	TTAGCAGATTGTCTTCAAGCTTATGGTC	{922}
3.0946160284948063	14803	15035	232	14803	1	1.0	TTTTGGTGATTTTATACAAACAGCCCCAGG	15005	1	1.0	TGGGGTATGAAGTATCATCCTAATACTGTG	1	1.0	TTGGTGTGGCAGTCGCAGATTCTTACTA	{14835}
3.1019857056612072	4711	4947	236	4711	1	1.0	GTCATTCTGTAGCTGTTATAGGTGATGAAC	4917	1	1.0	GCTGATGTTATTGTTAATCCTGCTAATGGG	1	1.0	ATGGTAAGTTTGTTACTAAATTTAGTGG	{4747}
3.103801953228442	658	895	237	658	1	1.0	GGTTGGATTGTACCTTTTGGTTTTATGCCA	865	1	1.0	CGTGGTATTAAACCCGTACTTTTTGTAGAC	1	1.0	CTTATGTTCACAAATGGTTTCAATTCTG	{689}
3.1074038657081178	2616	2855	239	2616	1	1.0	GCGTTTTCCATGTGCAGGTAGAAAAGTTAA	2825	1	1.0	TAAACTCTTGTAAAGAGCATCCAGTGGTTG	1	1.0	TTAACGAGAAACCTGTTGTTATGGAGAT	{2648}
3.1091897580044536	569	809	240	569	1	1.0	GCTTGTTCCGTTCATACAAGACTAAACGTT	779	1	1.0	TTAGTGTAGAAGATGCTTATGCTGAGGTTC	1	1.0	ATGTTGTACATCATCTTTCTATGACTAC	{599}
3.1091897580044536	8749	8989	240	8749	1	1.0	GTATCTCTGTAACCCAGACTATGTTTGATG	8959	1	1.0	CTAAATCTATGATATCTGCAGTAGCTGCTG	1	1.0	TTTATGTTGATACTTTTATGTCTCATTT	{8779}
3.1109657561098882	1873	2114	241	1873	1	1.0	CCCCGTAGTTATTATCTAATTCAGAGTGGT	2084	1	1.0	GGTTTAATACCATGTTAGATGCTAGTGCAC	1	1.0	TTTACATCTTTGATGTCTCAATTTTCAC	{1909}
3.1109657561098882	29647	29888	241	29647	1	1.0	GCTTGGTAAAGATTCTAAACCTCAGCAAGT	29858	1	1.0	GAATTAGCTCCTACACCAGGTGCTTTTTTC	1	1.0	TTTGTAATGTTCAACAGTGTTTTGGTAA	{29751}
3.1144885040667143	29868	30111	243	29868	1	1.0	CTACACCAGGTGCTTTTTTCTTTGGTTCTA	30081	1	1.0	TGAGTCCTAAACCTCAGCGTAAAAGAGGTG	1	1.0	GAACTTCGTTATTCTGGTTCTATTAGGT	{29954}
3.1248302666619225	2123	2372	249	2123	1	1.0	GCTGGCTTCTTTACCAATTATTGAATGGTC	2342	1	1.0	ACGTTAGTACAGGGTTAATTCCTGGTTTTG	1	1.0	TTTTGTAGTATCTCAAGCCAACTTTAAT	{2154}
3.1793942636811994	29274	29362	88	29274	1	1.0	TGTTACCGAGATGGTATTTCTACTATCTCG	29332	2	1.0	TGGTGAATCCCTCGAAGGGGTCTTCTGGGT TGGTGATGCCCACGAAGGTATCTTCTGGGT	1	1.0	GTACCGGCCCATATGCCAATGCATCCTA	{29304}
3.1793942636811994	29378	29466	88	29378	2	1.0	GACACTTCTACTCCCTCCGATGTTTCGTCA GACACTTCTATTCCCTCCGATGTTTCGGCA	29436	1	1.0	CTACTAGGTTTCCGCCTGGTACGATTTTGC	1	1.0	AGGGATCCTACTACTCAAGAAGCTATCC	{29408}
3.2320643733214482	29031	29124	93	29031	2	1.0	CCTATAATAGAGGCAGAAAACCCCAACCCA CCTTTAATAGAGGCAGAAAAACCCAACCTA	29094	1	1.0	CTATCCCACATTATTCCTGGTTCTCCGGGA	1	1.0	ATTCACTGTGTCTACTCAACCACAAGGA	{29062}
3.2856163730311914	20926	21025	99	20926	2	1.0	AGGTAATGCCAGCGGTAATGATGCTCTAGC GGGTAATGTCATTGGTAATGATGCTCTAAC	20995	1	1.0	TTTTGAACCTCGCTCAGATTTAGAACGGGA	1	1.0	CGTTTTACTATCTTTACTCAGAGTCGTG	{20957}
3.2904942636811993	19471	19559	88	19471	1	1.0	ACAACAGTGGGGTTATACAGGTTCTTTAAC	19529	2	1.0	CATAAAGGTGCACATGTTGCATCATCTGAT CATAAAGGTGCACATGTTGCGTCAGCTGAT	2	1.0	TAGTAATCACGATATAATTTGTAATGTA TAGTAATCATGATATAATTTGTAATGTA	{19501} {19501}
3.2904942636811993	29863	29951	88	29863	1	1.0	AGCTCCTACACCAGGTGCTTTTTTCTTTGG	29921	2	1.0	TCCGAGGCTGACTCACCTGTTAAAGATGTT TCTGATGCTGATTCACCTTCTAAAGACACT	2	1.0	CTCTAAATTAGAGTTGTTTAAAAGAGAC TTCTAAATTAGAGTTGGTTAAAAGAGAT	{29893} {29893}
3.358788527362399	29167	29276	109	29167	2	1.0	TCAAGGAGTACCCATTGCTTACGGGATACC TCAAGGAGTTCCCATTGCTTTCGGAGTACC	29246	1	1.0	AAAACAGCTGATGGTCAACAAAAGCAGTTG	1	1.0	CCTCTCTGAAGCAAAAGGATATTGGTAT	{29197}
3.4015942636811993	15007	15123	116	15007	1	1.0	GGGTATGAAGTATCATCCTAATACTGTGGA	15093	2	1.0	TGGTCTTACCTAATACTTGTTTTGGTCCTC TGGTTTTACCTAATACTTGTTTTGGTCCCC	1	1.0	TTGTGATAATGATAGGTGTATTATTCAT	{15037}
3.459085018119717	29095	29222	127	29095	1	1.0	TATCCCACATTATTCCTGGTTCTCCGGGAT	29192	2	1.0	GTACCCCCTTCTGAAGCAAAAGGATATTGG GTACCCCTCTCTGAAGCAAAAGGATATTGG	1	1.0	GAGACTTTAAATTTTCAGATGGTCAAGG	{29145}
3.459085018119717	29721	29848	127	29721	1	1.0	AACCTCGCCAAAAGCGAACTCCTAATAAAC	29818	2	1.0	AAAGCTTGGTACTAATGATCCTCAGTTTCC AAAGCTTGGTACTAGTGATCCTCAATTTCC	1	1.0	TTTGTAATGTTCAACAGTGTTTTGGTAA	{29751}
3.4821573353204816	19553	19685	132	19553	2	1.0	GCTGATGCAATTATGACTCGTTGTTTAGCA TCTGATGCAATTATGACTCGGTGTTTAGCA	19655	1	1.0	AATACATCTTGTAGGTTATTGCAGCGTGTC	1	1.0	ATTGGAATTTAGATTATCCAATAATTTC	{19611}
3.4994894934871645	15202	15338	136	15202	2	1.0	GAACTTAGATGTTGACACACACCGTTATCG GAACTTGGATGTTGACACACACCGCTATCG	15308	1	1.0	TTACGAACTTGTTGTTTTAGTGTAGCTGCC	1	1.0	TGCTATGCATGTTGCATCTGCTAGTGCT	{15271}
3.4994894934871645	29378	29514	136	29378	2	1.0	GACACTTCTACTCCCTCCGATGTTTCGTCA GACACTTCTATTCCCTCCGATGTTTCGGCA	29484	1	1.0	AAGGCTCAGGAAGGTCTGCTTCTAATAGTC	1	1.0	AGGGATCCTACTACTCAAGAAGCTATCC	{29408}
3.539116028494806	21003	21149	146	21003	1	1.0	CTCGCTCAGATTTAGAACGGGATTTTATTG	21119	2	1.0	GTTATAGGAGGTTTGCACTTGCTTATAGGT GTTATAGGAGGTTTGCATTTGCTTATAGGC	1	1.0	CTGTTTATAGCCAAATATGGTTTAGAAG	{21047}
3.565364373321448	29058	29184	126	29058	1	1.0	CTAAATTCACTGTGTCTACTCAACCACAAG	29154	2	1.0	AATTTCCAGATGGTCAAGGAGTACCCATTG AATTTTCAGATGGTCAAGGAGTTCCCATTG	2	1.0	GAAACCCTATCCCACATTATTCCTGGTT TATCCCACATTATTCCTGGTTCTCCGGG	{29088} {29095}
3.584243040981689	29063	29222	159	29063	1	1.0	TTCACTGTGTCTACTCAACCACAAGGAAAT	29192	2	1.0	GTACCCCCTTCTGAAGCAAAAGGATATTGG GTACCCCTCTCTGAAGCAAAAGGATATTGG	1	1.0	GAGACTTTAAATTTTCAGATGGTCAAGG	{29145}
3.6031053540254123	15007	15172	165	15007	1	1.0	GGGTATGAAGTATCATCCTAATACTGTGGA	15142	2	1.0	AGATGGTGTACCGTTTGTTGTTTCTATTGG AGATGGTGTTCCGTTTGTTGTTTCAATTGG	1	1.0	TTGTGATAATGATAGGTGTATTATTCAT	{15037}
3.6121360029807223	18217	18385	168	18217	2	1.0	GTGCTGTTTAGGTCCTGATATTTTTTTGGG GTGTTGTTTAGGTCCTGATATCTTTTTGGG	18355	1	1.0	TTTTAAGGGACAGACAACACATGAGAGTTC	1	1.0	GAAATTGTAGAAACTGTTTCAGCATTGG	{18269}
3.6426729313414405	29647	29791	144	29647	1	1.0	GCTTGGTAAAGATTCTAAACCTCAGCAAGT	29761	2	1.0	TCAACAGTGTTTTGGTAAAAGAGGACCGCT TCAACAGTGTTTTGGTAAAAGAGGACCTTC	2	1.0	AGCGAACTCCCAATAAACATTGTAATGT TCGCCAAAAGCGAACTCCTAATAAACAT	{29733} {29725}
3.643228507007025	29759	29938	179	29759	1	1.0	GTTCAACAGTGTTTTGGTAAAAGAGGACCT	29908	2	1.0	GGTTAAAAGAGATTCCGAGGCTGACTCACC GTTTAAAAGAGACTCTGATGCTGATTCACC	1	1.0	TGGTAATGCTGAAATGTTAAAGCTTGGT	{29800}
3.6589972680519156	29120	29305	185	29120	2	1.0	GGGATCACTCAATTTCAAAAAGGTAGAGAC GGGATTACCCAATTTCAAAAAGGTAGAGAC	29275	1	1.0	GTTACCGAGATGGTATTTCTACTATCTCGG	1	1.0	CCCCTTTCTGAAGCAAAAGGATATTGGT	{29195}
3.6640857374007747	19791	19978	187	19791	2	1.0	CTTCTCCTGTTGTCAAGTCTGTTAAACAGT CTTTTCCTGTAGCCAAGTCTGTTAAACAGT	19948	1	1.0	ATTAAACCTTCCTGGATGTAATGGTGGTAG	1	1.0	GTCTATGATGTGCATAAAGATAATTTTA	{19829}
3.669094696155047	29922	30111	189	29922	2	1.0	CCGAGGCTGACTCACCTGTTAAAGATGTTT CTGATGCTGATTCACCTTCTAAAGACACTT	30081	1	1.0	TGAGTCCTAAACCTCAGCGTAAAAGAGGTG	1	1.0	GAACTTCGTTATTCTGGTTCTATTAGGT	{29954}
3.674026590941621	15147	15338	191	15147	2	1.0	GTGTACCGTTTGTTGTTTCTATTGGTTACC GTGTTCCGTTTGTTGTTTCAATTGGTTACC	15308	1	1.0	TTACGAACTTGTTGTTTTAGTGTAGCTGCC	1	1.0	TGCTATGCATGTTGCATCTGCTAGTGCT	{15271}
3.6812850181197168	20955	21149	194	20955	1	1.0	CACGTTTTACTATCTTTACTCAGAGTCGTG	21119	2	1.0	GTTATAGGAGGTTTGCACTTGCTTATAGGT GTTATAGGAGGTTTGCATTTGCTTATAGGC	1	1.0	CGCTCAGATTTAGAACGGGATTTTATTG	{21005}
3.697608310503012	29647	29848	201	29647	1	1.0	GCTTGGTAAAGATTCTAAACCTCAGCAAGT	29818	2	1.0	AAAGCTTGGTACTAATGATCCTCAGTTTCC AAAGCTTGGTACTAGTGATCCTCAATTTCC	1	1.0	TTTGTAATGTTCAACAGTGTTTTGGTAA	{29751}
3.723791578646307	28983	29196	213	28983	1	1.0	TCCTCAAGAAAACTTCTTGGGCTGACCAAT	29166	2	1.0	GTCAAGGAGTACCCATTGCTTACGGGATAC GTCAAGGAGTTCCCATTGCTTTCGGAGTAC	1	1.0	ATAGAGGCAGAAAACCCCAACCCAAATT	{29037}
3.7320647304037196	29721	29938	217	29721	1	1.0	AACCTCGCCAAAAGCGAACTCCTAATAAAC	29908	2	1.0	GGTTAAAAGAGATTCCGAGGCTGACTCACC GTTTAAAAGAGACTCTGATGCTGATTCACC	1	1.0	TTTGTAATGTTCAACAGTGTTTTGGTAA	{29751}
3.736122592664184	15007	15226	219	15007	1	1.0	GGGTATGAAGTATCATCCTAATACTGTGGA	15196	2	1.0	AGTTATGAACTTAGATGTTGACACACACCG AGTTATGAACTTGGATGTTGATACACACCG	1	1.0	TTGTGATAATGATAGGTGTATTATTCAT	{15037}
3.736122592664184	18166	18385	219	18166	2	1.0	GAGCAAGGGTTCTTTAGAACCTAGGCACTT GAGTAAGGGTTCTTTAGAACCTAGGCATTT	18355	1	1.0	TTTTAAGGGACAGACAACACATGAGAGTTC	1	1.0	TGATATCTTTTTGGGAAATTGTTATAGG	{18232}
3.7686857056612073	15102	15338	236	15102	2	1.0	CTAATACTTGTTTTGGTCCCCTTGTTAGAC CTAATACTTGTTTTGGTCCTCTTGTCAGAC	15308	1	1.0	TTACGAACTTGTTGTTTTAGTGTAGCTGCC	1	1.0	TGCTATGCATGTTGCATCTGCTAGTGCT	{15271}
3.7686857056612073	19523	19759	236	19523	1	1.0	AATGTACATAAAGGTGCACATGTTGCGTCA	19729	2	1.0	TGACATAGGCAATCCTAAAGGTTTAGCTTG TGACATTGGCAATCCTAAAGGTATTGCTTG	1	1.0	ATTGGAATTTAGATTATCCAATAATTTC	{19611}
3.7741038657081174	15202	15441	239	15202	2	1.0	GAACTTAGATGTTGACACACACCGTTATCG GAACTTGGATGTTGACACACACCGCTATCG	15411	1	1.0	GTAAAGGCTTGTTTAAAGAGGGTAGTACAG	1	1.0	TGCTATGCATGTTGCATCTGCTAGTGCT	{15271}
3.777665756109888	19737	19978	241	19737	2	1.0	GCAATCCTAAAGGTATTGCTTGTGTCAAAG GCAATCCTAAAGGTTTAGCTTGTGTCAAAG	19948	1	1.0	ATTAAACCTTCCTGGATGTAATGGTGGTAG	1	1.0	GCCAAGTTTGTTAAACAGTTATTTTATG	{19802}
3.777665756109888	29607	29848	241	29607	1	1.0	CTGATATGGCTGATGAGATTGCTAATCTTG	29818	2	1.0	AAAGCTTGGTACTAATGATCCTCAGTTTCC AAAGCTTGGTACTAGTGATCCTCAATTTCC	1	1.0	CAAGCTTGGTAAAGATTCTAAACCTCAG	{29644}
3.7811885040667144	28983	29226	243	28983	1	1.0	TCCTCAAGAAAACTTCTTGGGCTGACCAAT	29196	2	1.0	CCCCTTCTGAAGCAAAAGGATATTGGTATA CCCTCTCTGAAGCAAAAGGATATTGGTATA	1	1.0	ATAGAGGCAGAAAACCCCAACCCAAATT	{29037}
3.983616028494806	18144	18247	103	18144	2	1.0	TACCTGCACCACGTGTGCTATTGAGTAAGG TACCTGCACCACGTGTGCTGTTGAGCAAGG	18217	2	1.0	GTGCTGTTTAGGTCCTGATATTTTTTTGGG GTGTTGTTTAGGTCCTGATATCTTTTTGGG	1	1.0	GTTCTTTAGAACCTAGGCACTTCAATTC	{18174}
4.125785018119718	21439	21566	127	21439	2	1.0	CTGGAAACCTGGTTATTCTATGCCTGTTTT TTGGAAACCTGGCTATTCTATGCCTGTTTT	21536	2	1.0	CCAACAGGTTGTATGATGAATGTTGCTAAG CCTACAGGCTGTATGATGAATGTTGCTAAG	1	1.0	GTATAAGTATTTGAATGTTCCATTAGAG	{21469}
4.375479016983141	19553	19759	206	19553	2	1.0	GCTGATGCAATTATGACTCGTTGTTTAGCA TCTGATGCAATTATGACTCGGTGTTTAGCA	19729	2	1.0	TGACATAGGCAATCCTAAAGGTTTAGCTTG TGACATTGGCAATCCTAAAGGTATTGCTTG	1	1.0	ATTGGAATTTAGATTATCCAATAATTTC	{19611}
4.388389493487165	21439	21651	212	21439	2	1.0	CTGGAAACCTGGTTATTCTATGCCTGTTTT TTGGAAACCTGGCTATTCTATGCCTGTTTT	21621	2	1.0	TGCGTGTCTTACACTTAGGTGCAGGATCTG TGCGTGTTTTACATTTAGGTGCAGGGTCTG	1	1.0	GTATAAGTATTTGAATGTTCCATTAGAG	{21469}
4.394654842851936	29120	29335	215	29120	2	1.0	GGGATCACTCAATTTCAAAAAGGTAGAGAC GGGATTACCCAATTTCAAAAAGGTAGAGAC	29305	2	1.0	TACCGGCCCATATGCCAATGCATCCTATGG TACCGGTCCATATGCCAGTTCATCCTATGG	1	1.0	CCCCTTTCTGAAGCAAAAGGATATTGGT	{29195}
4.446131969052151	21439	21681	242	21439	2	1.0	CTGGAAACCTGGTTATTCTATGCCTGTTTT TTGGAAACCTGGCTATTCTATGCCTGTTTT	21651	2	1.0	ATAAAGAAGTAGCCCCTGGTTCTGCTGTTT ATAAAGAAGTAGCTCCAGGTTCTGCTGTTT	1	1.0	GTATAAGTATTTGAATGTTCCATTAGAG	{21469}
4.451372960526725	29120	29365	245	29120	2	1.0	GGGATCACTCAATTTCAAAAAGGTAGAGAC GGGATTACCCAATTTCAAAAAGGTAGAGAC	29335	2	1.0	TGAATCCCTCGAAGGGGTCTTCTGGGTTGC TGATGCCCACGAAGGTATCTTCTGGGTCGC	1	1.0	CCCCTTTCTGAAGCAAAAGGATATTGGT	{29195}
