cost	target-start	target-end	target-length	left-primer-start	left-primer-num-primers	left-primer-frac-bound	left-primer-target-sequences	right-primer-start	right-primer-num-primers	right-primer-frac-bound	right-primer-target-sequences	num-guides	total-frac-bound-by-guides	guide-target-sequences	guide-target-sequence-positions
2.5126942636811997	3012	3100	88	3012	1	1.0	GGCTTCACATATGTATTGTTCTTTCTACCC	3070	1	1.0	TGTGAAGAAGAAGAGTTTGAGCCATCAACT	1	1.0	TCCAGATGAGGATGAAGAAGAAGGTGAT	{3042}
2.5126942636811997	3155	3243	88	3155	1	1.0	CCACTTCTGCTGCTCTTCAACCTGAAGAAG	3213	1	1.0	TAGTCAACAAACTGTTGGTCAACAAGACGG	1	1.0	AGCAAGAAGAAGATTGGTTAGATGATGA	{3185}
2.5126942636811997	8800	8888	88	8800	1	1.0	ACTAATGACAAAGCTTGCCCATTGATTGCT	8858	1	1.0	TCGTGCCTGGTTTGCCTGGCACGATATTAC	1	1.0	GCAGTCATAACAAGAGAAGTGGGTTTTG	{8830}
2.5126942636811997	14121	14209	88	14121	1	1.0	GGTAGTGGAGTTCCTGTTGTAGATTCTTAT	14179	1	1.0	TGACCAGGGCTTTAACTGCAGAGTCACATG	1	1.0	TATTCATTGTTAATGCCTATATTAACCT	{14151}
2.5126942636811997	15696	15784	88	15696	1	1.0	TTCTCAATGATGATACTCTCTGACGATGCT	15754	1	1.0	CTCAAGGTCTAGTGGCTAGCATAAAGAACT	1	1.0	GTTGTGTGTTTCAATAGCACTTATGCAT	{15726}
2.5126942636811997	16204	16292	88	16204	1	1.0	AGGCTATGTACACACCGCATACAGTCTTAC	16262	1	1.0	TTCACAGACTTCATTAAGATGTGGTGCTTG	1	1.0	AGGCTGTTGGGGCTTGTGTTCTTTGCAA	{16234}
2.5126942636811997	18236	18324	88	18236	1	1.0	TAATGGTTACCCTAACATGTTTATCACCCG	18294	1	1.0	TGGATTGGCTTCGATGTCGAGGGGTGTCAT	1	1.0	CGAAGAAGCTATAAGACATGTACGTGCA	{18266}
2.5126942636811997	18626	18714	88	18626	1	1.0	GTATTTTGTGAAAATAGGACCTGAGCGCAC	18684	1	1.0	TGCTTTTCCACTGCTTCAGACACTTATGCC	1	1.0	CTGTTGTCTATGTGATAGACGTGCCACA	{18656}
2.5126942636811997	18936	19024	88	18936	1	1.0	GGTGATGAACTGAAGATTAATGCGGCTTGT	18994	1	1.0	CTGCATTATTAGCAGACAAATTCCCAGTTC	1	1.0	AGAAAGGATCAACACATGGTTGTTAAAG	{18966}
2.5126942636811997	19463	19551	88	19463	1	1.0	ACGTTGCAATTTAGGTGGTGCTGTCTGTAG	19521	1	1.0	CTCGATGCTTATAACATGATGATCTCAGCT	1	1.0	ACATCATGCTAATGAGTACAGATTGTAT	{19493}
2.5126942636811997	19868	19956	88	19868	1	1.0	TGTGATCTGGGACTACAAAAGAGATGCTCC	19926	1	1.0	TCTATGACTGACATAGCCAAGAAACCAACT	1	1.0	AGCACATATATCTACTATTGGTGTTTGT	{19898}
2.5126942636811997	20023	20111	88	20023	1	1.0	GAAATGCCCGTAATGGTGTTCTTATTACAG	20081	1	1.0	TGTAGGTCCCAAACAAGCTAGTCTTAATGG	1	1.0	AAGGTAGTGTTAAAGGTTTACAACCATC	{20053}
2.5126942636811997	20876	20964	88	20876	1	1.0	TTCTGATAAAGGAGTTGCACCAGGTACAGC	20934	1	1.0	ACGCTGCTTGTCGATTCAGATCTTAATGAC	1	1.0	TGTTTTAAGACAGTGGTTGCCTACGGGT	{20906}
2.5126942636811997	21844	21932	88	21844	1	1.0	CACTGAGAAGTCTAACATAATAAGAGGCTG	21902	1	1.0	ACCCAGTCCCTACTTATTGTTAATAACGCT	1	1.0	GATTTTTGGTACTACTTTAGATTCGAAG	{21874}
2.5126942636811997	22576	22664	88	22576	1	1.0	TGGTGAAGTTTTTAACGCCACCAGATTTGC	22634	1	1.0	ATCAGCAACTGTGTTGCTGATTATTCTGTC	1	1.0	ATCTGTTTATGCTTGGAACAGGAAGAGA	{22606}
2.5126942636811997	22626	22714	88	22626	1	1.0	GGAAGAGAATCAGCAACTGTGTTGCTGATT	22684	1	1.0	TTCCACTTTTAAGTGTTATGGAGTGTCTCC	1	1.0	ATTCTGTCCTATATAATTCCGCATCATT	{22656}
2.5126942636811997	22932	23020	88	22932	1	1.0	GGAAGTCTAATCTCAAACCTTTTGAGAGAG	22990	1	1.0	TAGCACACCTTGTAATGGTGTTGAAGGTTT	1	1.0	ATATTTCAACTGAAATCTATCAGGCCGG	{22962}
2.5126942636811997	23591	23679	88	23591	1	1.0	CAGACTAATTCTCCTCGGCGGGCACGTAGT	23649	1	1.0	CTATGTCACTTGGTGCAGAAAATTCAGTTG	1	1.0	GTAGCTAGTCAATCCATCATTGCCTACA	{23621}
2.5126942636811997	24147	24235	88	24147	1	1.0	CACCTTTGCTCACAGATGAAATGATTGCTC	24205	1	1.0	AATCACTTCTGGTTGGACCTTTGGTGCAGG	1	1.0	AATACACTTCTGCACTGTTAGCGGGTAC	{24177}
2.5126942636811997	24850	24938	88	24850	1	1.0	TTCAAATGGCACACACTGGTTTGTAACACA	24908	1	1.0	ACTACAGACAACACATTTGTGTCTGGTAAC	1	1.0	AAGGAATTTTTATGAACCACAAATCATT	{24880}
2.5126942636811997	25534	25622	88	25534	1	1.0	GTTGGCGTTGCACTTCTTGCTGTTTTTCAG	25592	1	1.0	AGAGATGGCAACTAGCACTCTCCAAGGGTG	1	1.0	AGCGCTTCCAAAATCATAACCCTCAAAA	{25564}
2.5126942636811997	25612	25700	88	25612	1	1.0	TCCAAGGGTGTTCACTTTGTTTGCAACTTG	25670	1	1.0	ACCTTTTGCTCGTTGCTGCTGGCCTTGAAG	1	1.0	CTGTTGTTGTTTGTAACAGTTTACTCAC	{25642}
2.5126942636811997	25886	25974	88	25886	1	1.0	CTTCAATTGTCATTACTTCAGGTGATGGCA	25944	1	1.0	CCAGATTGGTGGTTATACTGAAAAATGGGA	1	1.0	CAACAAGTCCTATTTCTGAACATGACTA	{25916}
2.5239433771173467	23126	23215	89	23126	1	1.0	GCAACTGTTTGTGGACCTAAAAAGTCTACT	23185	1	1.0	CAACTTCAATGGTTTAACAGGCACAGGTGT	1	1.0	ATTTGGTTAAAAACAAATGTGTCAATTT	{23157}
2.5239433771173467	27576	27665	89	27576	1	1.0	TCAATTTGCTTTTGCTTGTCCTGACGGCGT	27635	1	1.0	CAGTTTCACCTAAACTGTTCATCAGACAAG	1	1.0	AAAACACGTCTATCAGTTACGTGCCAGA	{27606}
2.5239433771173467	27644	27733	89	27644	1	1.0	CTAAACTGTTCATCAGACAAGAGGAAGTTC	27703	1	1.0	GTTGCGGCAATAGTGTTTATAACACTTTGC	1	1.0	AAGAACTTTACTCTCCAATTTTTCTTAT	{27674}
2.534811090344213	1915	2005	90	1915	1	1.0	ACTCTTGAAACTGCTCAAAATTCTGTGCGT	1975	1	1.0	GATGGAATTTCACAGTATTCACTGAGACTC	1	1.0	GTTTTACAGAAGGCCGCTATAACAATAC	{1945}
2.534811090344213	4106	4196	90	4106	1	1.0	AAGATGCTCCATATATAGTGGGTGATGTTG	4166	1	1.0	TACCTACTAAAAAGGCTGGTGGCACTACTG	1	1.0	TTCAAGAGGGTGTTTTAACTGCTGTGGT	{4136}
2.534811090344213	4433	4523	90	4433	1	1.0	CTGTCTGTGTGGAAACTAAAGCCATAGTTT	4493	1	1.0	AAATACAAGAGGGTGTGGTTGATTATGGTG	1	1.0	CAACTATACAGCGTAAATATAAGGGTAT	{4463}
2.534811090344213	14484	14574	90	14484	1	1.0	AGAGAGCTAGGTGTTGTACATAATCAGGAT	14544	1	1.0	AAGGAATTACTTGTGTATGCTGCTGACCCT	1	1.0	GTAAACTTACATAGCTCTAGACTTAGTT	{14514}
2.534811090344213	18701	18791	90	18701	1	1.0	AGACACTTATGCCTGTTGGCATCATTCTAT	18761	1	1.0	GATTGATGTTCAACAATGGGGTTTTACAGG	1	1.0	TGGATTTGATTACGTCTATAATCCGTTT	{18731}
2.534811090344213	22352	22442	90	22352	1	1.0	GCTTATTATGTGGGTTATCTTCAACCTAGG	22412	1	1.0	ACCATTACAGATGCTGTAGACTGTGCACTT	1	1.0	TTTTCTATTAAAATATAATGAAAATGGA	{22384}
2.5453224201679636	12046	12137	91	12046	1	1.0	AACAAGCTTTGTGAAGAAATGCTGGACAAC	12107	1	1.0	TTAGTTCCCTTCCATCATATGCAGCTTTTG	1	1.0	AGGGCAACCTTACAAGCTATAGCCTCAG	{12076}
2.5453224201679636	22009	22100	91	22009	1	1.0	CAAAAGTTGGATGGAAAGTGAGTTCAGAGT	22070	1	1.0	TATGTCTCTCAGCCTTTTCTTATGGACCTT	1	1.0	TTCTAGTGCGAATAATTGCACTTTTGAA	{22042}
2.5555	18300	18392	92	18300	1	1.0	GGCTTCGATGTCGAGGGGTGTCATGCTACT	18362	1	1.0	GCTAGGTTTTTCTACAGGTGTTAACCTAGT	1	1.0	AGAGAAGCTGTTGGTACCAATTTACCTT	{18330}
2.5555	18394	18486	92	18394	1	1.0	CTGTACCTACAGGTTATGTTGATACACCTA	18456	1	1.0	CCACCGCCTGGAGATCAATTTAAACACCTC	1	1.0	TAATACAGATTTTTCCAGAGTTAGTGCT	{18425}
2.5555	25222	25314	92	25222	1	1.0	TATAGCTGGCTTGATTGCCATAGTAATGGT	25284	1	1.0	GTAGTTGTCTCAAGGGCTGTTGTTCTTGTG	1	1.0	GACAATTATGCTTTGCTGTATGACCAGT	{25252}
2.565364373321448	6301	6394	93	6301	1	1.0	CTTTGGAGCACAAAACCAGTTGAAACATCA	6364	1	1.0	CAGGGAATGGATAATCTTGCCTGCGAAGAT	1	1.0	GTTTGATGTACTGAAGTCAGAGGACGCG	{6336}
2.565364373321448	9066	9159	93	9066	1	1.0	TGATACCAATGTACTAGAAGGTTCTGTTGC	9129	1	1.0	GCTCATGGATGGCTCTATTATTCAATTTCC	1	1.0	TTATGAAAGTTTACGCCCTGACACACGT	{9096}
2.565364373321448	11326	11419	93	11326	1	1.0	GCTGTAGTGTTACTAATCCTTATGACAGCA	11389	1	1.0	TGGACACTTATGAATGTCTTGACACTCGTT	1	1.0	TGTGTATGATGATGGTGCTAGGAGAGTG	{11361}
2.565364373321448	17963	18056	93	17963	1	1.0	GTCTGATAGAGACCTTTATGACAAGTTGCA	18026	1	1.0	GGCAACTTTACAAGCTGAAAATGTAACAGG	1	1.0	TTACAAGTCTTGAAATTCCACGTAGGAA	{17995}
2.5749342433258255	12466	12560	94	12466	1	1.0	GCCAAACTAATGGTTGTCATACCAGACTAT	12530	1	1.0	TTACTTATGCATCAGCATTGTGGGAAATCC	1	1.0	ACACATATAAAAATACGTGTGATGGTAC	{12497}
2.5749342433258255	23454	23548	94	23454	1	1.0	CTACTTGGCGTGTTTATTCTACAGGTTCTA	23518	1	1.0	GGCTGAACATGTCAACAACTCATATGAGTG	1	1.0	TGTTTTTCAAACACGTGCAGGCTGTTTA	{23485}
2.5749342433258255	29174	29268	94	29174	1	1.0	TGGCCGCAAATTGCACAATTTGCCCCCAGC	29238	1	1.0	TGGAAGTCACACCTTCGGGAACGTGGTTGA	1	1.0	GCTTCAGCGTTCTTCGGAATGTCGCGCA	{29204}
2.5842266863651715	18026	18121	95	18026	1	1.0	GGCAACTTTACAAGCTGAAAATGTAACAGG	18091	1	1.0	TACATCCTACACAGGCACCTACACACCTCA	1	1.0	AAAGATTGTAGTAAGGTAATCACTGGGT	{18063}
2.5842266863651715	28343	28438	95	28343	1	1.0	ACTGGCAGTAACCAGAATGGAGAACGCAGT	28408	1	1.0	ACCCAATAATACTGCGTCTTGGTTCACCGC	1	1.0	GGGGCGCGATCAAAACAACGTCGGCCCC	{28373}
2.6020405378427527	14189	14286	97	14189	1	1.0	TTTAACTGCAGAGTCACATGTTGACACTGA	14256	1	1.0	TATGACTTCACGGAAGAGAGGTTAAAACTC	1	1.0	CTTAACAAAGCCTTACATTAAGTGGGAT	{14219}
2.6020405378427527	23259	23356	97	23259	1	1.0	GCAGAGACATTGCTGACACTACTGATGCTG	23326	1	1.0	ACCATGTTCTTTTGGTGGTGTCAGTGTTAT	1	1.0	TCCGTGATCCACAGACACTTGAGATTCT	{23289}
2.6189163730311917	19177	19276	99	19177	1	1.0	GTGTATGCCTATTTTGGAATTGCAATGTCG	19246	1	1.0	CTAGAGTGCTATCTAACCTTAACTTGCCTG	1	1.0	ATAGATATCCTGCTAATTCCATTGTTTG	{19207}
2.6189163730311917	20306	20405	99	20306	1	1.0	CTATGCCTTCGAACATATCGTTTATGGAGA	20375	1	1.0	TGGACTAGCTAAACGTTTTAAGGAATCACC	1	1.0	TTTAGTCATAGTCAGTTAGGTGGTTTAC	{20337}
2.6270324226839716	3637	3737	100	3637	1	1.0	GGTGAAGACATTCAACTTCTTAAGAGTGCT	3707	1	1.0	TATTATCAGCTGGTATTTTTGGTGCTGACC	1	1.0	AATTTTAATCAGCACGAAGTTCTACTTG	{3673}
2.6349480554261384	10187	10288	101	10187	1	1.0	CCTCTGAAGACATGCTTAACCCTAATTATG	10258	1	1.0	CAGGCTGGTAATGTTCAACTCAGGGTTATT	1	1.0	TCGTAAGTCTAATCATAATTTCTTGGTA	{10230}
2.6349480554261384	22765	22866	101	22765	1	1.0	AATTAGAGGTGATGAAGTCAGACAAATCGC	22836	1	1.0	TACCAGATGATTTTACAGGCTGCGTTATAG	1	1.0	TCCAGGGCAAACTGGAAAGATTGCTGAT	{22795}
2.6349480554261384	28088	28189	101	28088	1	1.0	TGGTTCTAAATCACCCATTCAGTACATCGA	28159	1	1.0	ATTGCCAGGAACCTAAATTGGGTAGTCTTG	1	1.0	TATCGGTAATTATACAGTTTCCTGTTTA	{28118}
2.6502160284948064	454	557	103	454	1	1.0	CTTGAACAGCCCTATGTGTTCATCAAACGT	527	1	1.0	TGGTAGCAGAACTCGAAGGCATTCAGTACG	1	1.0	TCGGATGCTCGAACTGCACCTCATGGTC	{484}
2.6718354666358684	27988	28094	106	27988	1	1.0	TAGTTGATGACCCGTGTCCTATTCACTTCT	28064	1	1.0	AATTGAATTGTGCGTGGATGAGGCTGGTTC	1	1.0	ATTCTAAATGGTATATTAGAGTAGGAGC	{28018}
2.678729642842771	18781	18888	107	18781	1	1.0	GTTTTACAGGTAACCTACAAAGCAACCATG	18858	1	1.0	GCAATCATGACTAGGTGTCTAGCTGTCCAC	1	1.0	TCTGTATTGTCAAGTCCATGGTAATGCA	{18812}
2.678729642842771	22992	23099	107	22992	1	1.0	GCACACCTTGTAATGGTGTTGAAGGTTTTA	23069	1	1.0	GTTGGTTACCAACCATACAGAGTAGTAGTA	1	1.0	ATTGTTACTTTCCTTTACAATCATATGG	{23022}
2.6920885273623996	21763	21872	109	21763	1	1.0	TATACATGTCTCTGGGACCAATGGTACTAA	21842	1	1.0	TCCACTGAGAAGTCTAACATAATAAGAGGC	1	1.0	GAGGTTTGATAACCCTGTCCTACCATTT	{21793}
2.6985648453679434	3500	3610	110	3500	1	1.0	CTAACAATGCCATGCAAGTTGAATCTGATG	3580	1	1.0	AGCGGACACAATCTTGCTAAACACTGTCTT	1	1.0	TAGCTACTAATGGACCACTTAAAGTGGG	{3536}
2.704912910986066	12553	12664	111	12553	1	1.0	GAAATCCAACAGGTTGTAGATGCAGATAGT	12634	1	1.0	TGGCCTCTTATTGTAACAGCTTTAAGGGCC	1	1.0	TAGTATGGACAATTCACCTAATTTAGCA	{12606}
2.704912910986066	13147	13258	111	13147	1	1.0	GTTAAGATGTTGTGTACACACACTGGTACT	13228	1	1.0	GGTGGTGCATCGTGTTGTCTGTACTGCCGT	1	1.0	GGTCAGGCAATAACAGTTACACCGGAAG	{13177}
2.704912910986066	22225	22336	111	22225	1	1.0	GGCTTTAGAACCATTGGTAGATTTGCCAAT	22306	1	1.0	TTTGACTCCTGGTGATTCTTCTTCAGGTTG	1	1.0	AGGTATTAACATCACTAGGTTTCAAACT	{22255}
2.704912910986066	23749	23860	111	23749	1	1.0	GTCTATGACCAAGACATCAGTAGATTGTAC	23830	1	1.0	TGGCAGTTTTTGTACACAATTAAACCGTGC	1	1.0	TGATTCAACTGAATGCAGCAATCTTTTG	{23794}
2.704912910986066	25699	25810	111	25699	1	1.0	GCCCCTTTTCTCTATCTTTATGCTTTAGTC	25780	1	1.0	TGCTGGAAATGCCGTTCCAAAAACCCATTA	1	1.0	TGTAAGAATAATAATGAGGCTTTGGCTT	{25752}
2.7348942636811997	80	196	116	80	1	1.0	AATCTGTGTGGCTGTCACTCGGCTGCATGC	166	1	1.0	GTAACTCGTCTATCTTCTGCAGGCTGCTTA	1	1.0	ACGCAGTATAATTAATAACTAATTACTG	{121}
2.7348942636811997	2055	2171	116	2055	1	1.0	AATGGCCTACATTACAGGTGGTGTTGTTCA	2141	1	1.0	CCGTCCTTGATTGGCTTGAAGAGAAGTTTA	1	1.0	GTTGACTTCGCAGTGGCTAACTAACATC	{2085}
2.7348942636811997	12797	12913	116	12797	1	1.0	GTAGGTTTGTACTTGCACTGTTATCCGATT	12883	1	1.0	ACAGAACTGGAACCACCTTGTAGGTTTGTT	1	1.0	TACAGGATTTGAAATGGGCTAGATTCCC	{12827}
2.7348942636811997	22093	22209	116	22093	1	1.0	GGACCTTGAAGGAAAACAGGGTAATTTCAA	22179	1	1.0	AGCACACGCCTATTAATTTAGTGCGTGATC	1	1.0	AAATCTTAGGGAATTTGTGTTTAAGAAT	{22123}
2.7405681611474058	11816	11933	117	11816	1	1.0	CTTGTATCAAAGTAGCCACTGTACAGTCTA	11903	1	1.0	GAGTAGAATCATCATCTAAATTGTGGGCTC	1	1.0	TCAGATGTAAAGTGCACATCAGTAGTCT	{11851}
2.7405681611474058	13407	13524	117	13407	1	1.0	TAGTTGTGATCAACTCCGCGAACCCATGCT	13494	1	1.0	CTTACACCGTGCGGCACAGGCACTAGTACT	1	1.0	TCAGTCAGCTGATGCACAATCGTTTTTA	{13437}
2.7405681611474058	24720	24837	117	24720	1	1.0	CTCAGTCAGCACCTCATGGTGTAGTCTTCT	24807	1	1.0	GTCATGATGGAAAAGCACACTTTCCTCGTG	1	1.0	TGCATGTGACTTATGTCCCTGCACAAGA	{24750}
2.7461433771173467	18236	18354	118	18236	1	1.0	TAATGGTTACCCTAACATGTTTATCACCCG	18324	1	1.0	GCTACTAGAGAAGCTGTTGGTACCAATTTA	1	1.0	CGAAGAAGCTATAAGACATGTACGTGCA	{18266}
2.751623285568201	3875	3994	119	3875	1	1.0	CTGAGATTCCTAAAGAGGAAGTTAAGCCAT	3964	1	1.0	GCTTGTGTTGAAGAAGTTACAACAACTCTG	1	1.0	TTCAGTTGAACAGAGAAAACAAGATGAT	{3924}
2.751623285568201	25927	26046	119	25927	1	1.0	ATTTCTGAACATGACTACCAGATTGGTGGT	26016	1	1.0	TTCAGACTATTACCAGCTGTACTCAACTCA	1	1.0	TATACTGAAAAATGGGAATCTGGAGTAA	{25957}
2.757011090344213	4067	4187	120	4067	1	1.0	CCACTCTTGTTAGTGACATTGACATCACTT	4157	1	1.0	CTGTGGTTATACCTACTAAAAAGGCTGGTG	1	1.0	TAGTGGGTGATGTTGTTCAAGAGGGTGT	{4121}
2.757011090344213	4106	4226	120	4106	1	1.0	AAGATGCTCCATATATAGTGGGTGATGTTG	4196	1	1.0	AAATGCTAGCGAAAGCTTTGAGAAAAGTGC	1	1.0	TTCAAGAGGGTGTTTTAACTGCTGTGGT	{4136}
2.757011090344213	22352	22472	120	22352	1	1.0	GCTTATTATGTGGGTTATCTTCAACCTAGG	22442	1	1.0	GACCCTCTCTCAGAAACAAAGTGTACGTTG	1	1.0	TTTTCTATTAAAATATAATGAAAATGGA	{22384}
2.7623098364064735	12046	12167	121	12046	1	1.0	AACAAGCTTTGTGAAGAAATGCTGGACAAC	12137	1	1.0	CTACTGCTCAAGAAGCTTATGAGCAGGCTG	1	1.0	AGGGCAACCTTACAAGCTATAGCCTCAG	{12076}
2.7623098364064735	14215	14336	121	14215	1	1.0	CTGACTTAACAAAGCCTTACATTAAGTGGG	14306	1	1.0	TTGGGATCAGACATACCACCCAAATTGTGT	1	1.0	TTCACGGAAGAGAGGTTAAAACTCTTTG	{14262}
2.7675224201679636	1915	2037	122	1915	1	1.0	ACTCTTGAAACTGCTCAAAATTCTGTGCGT	2007	1	1.0	TGATGCTATGATGTTCACATCTGATTTGGC	1	1.0	GTTTTACAGAAGGCCGCTATAACAATAC	{1945}
2.7675224201679636	18300	18422	122	18300	1	1.0	GGCTTCGATGTCGAGGGGTGTCATGCTACT	18392	1	1.0	TGCTGTACCTACAGGTTATGTTGATACACC	1	1.0	AGAGAAGCTGTTGGTACCAATTTACCTT	{18330}
2.7675224201679636	18394	18516	122	18394	1	1.0	CTGTACCTACAGGTTATGTTGATACACCTA	18486	1	1.0	ATACCACTTATGTACAAAGGACTTCCTTGG	1	1.0	TAATACAGATTTTTCCAGAGTTAGTGCT	{18425}
2.7675224201679636	25222	25344	122	25222	1	1.0	TATAGCTGGCTTGATTGCCATAGTAATGGT	25314	1	1.0	GATCCTGCTGCAAATTTGATGAAGACGACT	1	1.0	GACAATTATGCTTTGCTGTATGACCAGT	{25252}
2.7726515990016813	9066	9189	123	9066	1	1.0	TGATACCAATGTACTAGAAGGTTCTGTTGC	9159	1	1.0	TAACACCTACCTTGAAGGTTCTGTTAGAGT	1	1.0	TTATGAAAGTTTACGCCCTGACACACGT	{9096}
2.7726515990016813	19893	20016	123	19893	1	1.0	GCTCCAGCACATATATCTACTATTGGTGTT	19986	1	1.0	TTTGATGGTAGAGTTGATGGTCAAGTAGAC	1	1.0	ACATAGACAAGAAACCAACTGAAACGAT	{19936}
2.7726515990016813	22687	22810	123	22687	1	1.0	CACTTTTAAGTGTTATGGAGTGTCTCCTAC	22780	1	1.0	AGTCAGACAAATCGCTCCAGGGCAAACTGG	1	1.0	CAGATTCATTTGTAATTAGAGGTGATGA	{22752}
2.7777	14121	14245	124	14121	1	1.0	GGTAGTGGAGTTCCTGTTGTAGATTCTTAT	14215	1	1.0	CTGACTTAACAAAGCCTTACATTAAGTGGG	1	1.0	TATTCATTGTTAATGCCTATATTAACCT	{14151}
2.7777	20356	20480	124	20356	1	1.0	GTGGTTTACATCTACTGATTGGACTAGCTA	20450	1	1.0	CTATTTCATAACAGATGCGCAAACAGGTTC	1	1.0	AACGTTTTAAGGAATCACCTTTTGAATT	{20386}
2.7777	23454	23578	124	23454	1	1.0	CTACTTGGCGTGTTTATTCTACAGGTTCTA	23548	1	1.0	TGACATACCCATTGGTGCAGGTATATGCGC	1	1.0	TGTTTTTCAAACACGTGCAGGCTGTTTA	{23485}
2.7777	26452	26576	124	26452	1	1.0	GTTCCTGATCTTCTGGTCTAAACGAACTAA	26546	1	1.0	TACCGTTGAAGAGCTTAAAAAGCTCCTTGA	1	1.0	TAGCCATGGCAGATTCCAACGGTACTAT	{26518}
2.7777	29174	29298	124	29174	1	1.0	TGGCCGCAAATTGCACAATTTGCCCCCAGC	29268	1	1.0	CCTACACAGGTGCCATCAAATTGGATGACA	1	1.0	GCTTCAGCGTTCTTCGGAATGTCGCGCA	{29204}
2.782670128054922	15335	15460	125	15335	1	1.0	TATGGCCTCACTTGTTCTTGCTCGCAAACA	15430	1	1.0	GTGAAATGGTCATGTGTGGCGGTTCACTAT	1	1.0	TACAACGTGTTGTAGCTTGTCACACCGT	{15365}
2.782670128054922	28343	28468	125	28343	1	1.0	ACTGGCAGTAACCAGAATGGAGAACGCAGT	28438	1	1.0	TCTCACTCAACATGGCAAGGAAGACCTTAA	1	1.0	GGGGCGCGATCAAAACAACGTCGGCCCC	{28373}
2.792385018119717	6301	6428	127	6301	1	1.0	CTTTGGAGCACAAAACCAGTTGAAACATCA	6398	1	1.0	AACCAGTCTCTGAAGAAGTAGTGGAAAATC	1	1.0	GTTTGATGTACTGAAGTCAGAGGACGCG	{6336}
2.792385018119717	12346	12473	127	12346	1	1.0	GCTATGCAGACAATGCTTTTCACTATGCTT	12443	1	1.0	ACATAATACCTCTTACAACAGCAGCCAAAC	1	1.0	CAATGCAAGAGATGGTTGTGTTCCCTTG	{12414}
2.8064266863651715	4433	4563	130	4433	1	1.0	CTGTCTGTGTGGAAACTAAAGCCATAGTTT	4533	1	1.0	CTTTTACACCAGTAAAACAACTGTAGCGTC	1	1.0	CAACTATACAGCGTAAATATAAGGGTAT	{4463}
2.8154573353204815	21904	22036	132	21904	1	1.0	CCAGTCCCTACTTATTGTTAATAACGCTAC	22006	1	1.0	CAACAAAAGTTGGATGGAAAGTGAGTTCAG	1	1.0	TAATGTTGTTATTAAAGTCTGTGAATTT	{21934}
2.81987901698314	454	587	133	454	1	1.0	CTTGAACAGCCCTATGTGTTCATCAAACGT	557	1	1.0	GTCGTAGTGGTGAGACACTTGGTGTCCTTG	1	1.0	TCGGATGCTCGAACTGCACCTCATGGTC	{484}
2.81987901698314	15651	15784	133	15651	1	1.0	GACACAGACTTTGTGAATGAGTTTTACGCA	15754	1	1.0	CTCAAGGTCTAGTGGCTAGCATAAAGAACT	1	1.0	GTTGTGTGTTTCAATAGCACTTATGCAT	{15726}
2.81987901698314	20899	21032	133	20899	1	1.0	GTACAGCTGTTTTAAGACAGTGGTTGCCTA	21002	1	1.0	GTGCAACTGTACATACAGCTAATAAATGGG	1	1.0	CGGGTACGCTGCTTGTCGATTCAGATCT	{20929}
2.81987901698314	24858	24991	133	24858	1	1.0	GCACACACTGGTTTGTAACACAAAGGAATT	24961	1	1.0	CAACAACACAGTTTATGATCCTTTGCAACC	1	1.0	TTTATGAACCACAAATCATTACTACAGA	{24888}
2.8242405378427526	23678	23812	134	23678	1	1.0	GCTTACTCTAATAACTCTATTGCCATACCC	23782	1	1.0	GTACATTTGTGGTGATTCAACTGAATGCAG	1	1.0	TAGTGTTACCACAGAAATTCTACCAGTG	{23722}
2.8285435130281846	22854	22989	135	22854	1	1.0	GCTGCGTTATAGCTTGGAATTCTAACAATC	22959	1	1.0	GAGATATTTCAACTGAAATCTATCAGGCCG	1	1.0	GATTCTAAGGTTGGTGGTAATTATAATT	{22886}
2.8327894934871645	3176	3312	136	3176	1	1.0	CTGAAGAAGAGCAAGAAGAAGATTGGTTAG	3282	1	1.0	TGAGGTTCAACCTCAATTAGAGATGGAACT	1	1.0	ATGATGATAGTCAACAAACTGTTGGTCA	{3206}
2.8327894934871645	3310	3446	136	3310	1	1.0	CTTACACCAGTTGTTCAGACTATTGAAGTG	3416	1	1.0	AGGTAAAACCAACAGTGGTTGTTAATGCAG	1	1.0	AATAGTTTTAGTGGTTATTTAAAACTTA	{3340}
2.8327894934871645	25816	25952	136	25816	1	1.0	GATGCCAACTATTTTCTTTGCTGGCATACT	25922	1	1.0	GTCCTATTTCTGAACATGACTACCAGATTG	1	1.0	GTGTAACTTCTTCAATTGTCATTACTTC	{25877}
2.8327894934871645	27988	28124	136	27988	1	1.0	TAGTTGATGACCCGTGTCCTATTCACTTCT	28094	1	1.0	TAAATCACCCATTCAGTACATCGATATCGG	1	1.0	ATTCTAAATGGTATATTAGAGTAGGAGC	{28018}
2.8327894934871645	29231	29367	136	29231	1	1.0	ATTGGCATGGAAGTCACACCTTCGGGAACG	29337	1	1.0	AGCATATTGACGCATACAAAACATTCCCAC	1	1.0	TGGTTGACCTACACAGGTGCCATCAAAT	{29261}
2.836979969342407	6552	6689	137	6552	1	1.0	GGCTGCTTATGTAGACAATTCTAGTCTTAC	6659	1	1.0	GTGTCCCTTGGGATACTATAGCTAATTATG	1	1.0	ACCCTTGCTACTCATGGTTTAGCTGCTG	{6625}
2.836979969342407	17963	18100	137	17963	1	1.0	GTCTGATAGAGACCTTTATGACAAGTTGCA	18070	1	1.0	GTAGTAAGGTAATCACTGGGTTACATCCTA	1	1.0	TTACAAGTCTTGAAATTCCACGTAGGAA	{17995}
2.836979969342407	18781	18918	137	18781	1	1.0	GTTTTACAGGTAACCTACAAAGCAACCATG	18888	1	1.0	GAGTGCTTTGTTAAGCGTGTTGACTGGACT	1	1.0	TCTGTATTGTCAAGTCCATGGTAATGCA	{18812}
2.836979969342407	22992	23129	137	22992	1	1.0	GCACACCTTGTAATGGTGTTGAAGGTTTTA	23099	1	1.0	CTTTCTTTTGAACTTCTACATGCACCAGCA	1	1.0	ATTGTTACTTTCCTTTACAATCATATGG	{23022}
2.8411163730311917	16211	16349	138	16211	1	1.0	GTACACACCGCATACAGTCTTACAGGCTGT	16319	1	1.0	ATGCTGTTACGACCATGTCATATCAACATC	1	1.0	TGGGGCTTGTGTTCTTTGCAATTCACAG	{16241}
2.8411163730311917	18902	19040	138	18902	1	1.0	GCGTGTTGACTGGACTATTGAATATCCTAT	19010	1	1.0	CAAATTCCCAGTTCTTCACGACATTGGTAA	1	1.0	TGAAGATTAATGCGGCTTGTAGAAAGGA	{18946}
2.8411163730311917	25349	25487	138	25349	1	1.0	CCAGTGCTCAAAGGAGTCAAATTACATTAC	25457	1	1.0	ATGCTACTCCTTCAGATTTTGTTCGCGCTA	1	1.0	AGAATCTTCATAATTGGAACTGTAACTT	{25408}
2.8452000822449524	18187	18326	139	18187	1	1.0	CCTATAGAAGACTCATCTCTATGATGGGTT	18296	1	1.0	GATTGGCTTCGATGTCGAGGGGTGTCATGC	1	1.0	GCGAAGAAGCTATAAGACATGTACGTGC	{18265}
2.849232422683972	1056	1196	140	1056	1	1.0	CACCTTCAATGGGGAATGTCCAAATTTTGT	1166	1	1.0	GATCTGTCTATCCAGTTGCGTCACCAAATG	1	1.0	ATTTCCCTTAAATTCCATAATCAAGACT	{1086}
2.849232422683972	3500	3640	140	3500	1	1.0	CTAACAATGCCATGCAAGTTGAATCTGATG	3610	1	1.0	CATGTTGTCGGCCCAAATGTTAACAAAGGT	1	1.0	TAGCTACTAATGGACCACTTAAAGTGGG	{3536}
2.8532146706409636	13147	13288	141	13147	1	1.0	GTTAAGATGTTGTGTACACACACTGGTACT	13258	1	1.0	TGCCACATAGATCATCCAAATCCTAAAGGA	1	1.0	GGTCAGGCAATAACAGTTACACCGGAAG	{13177}
2.8532146706409636	22225	22366	141	22225	1	1.0	GGCTTTAGAACCATTGGTAGATTTGCCAAT	22336	1	1.0	GACAGCTGGTGCTGCAGCTTATTATGTGGG	1	1.0	AGGTATTAACATCACTAGGTTTCAAACT	{22255}
2.8571480554261384	8524	8666	142	8524	1	1.0	GTAACAACAAAGATAGCACTTAAGGGTGGT	8636	1	1.0	CACCTGTTCATGTCATGTCTAAACATACTG	1	1.0	AAAGTTACACTTGTGTTCCTTTTTGTTG	{8587}
2.8648729313414405	15599	15743	144	15599	1	1.0	CCGCAATTTACAACACAGACTTTATGAGTG	15713	1	1.0	CTCTGACGATGCTGTTGTGTGTTTCAATAG	1	1.0	CTATAGAAATAGAGATGTTGACACAGAC	{15632}
2.8686666660097973	3012	3157	145	3012	1	1.0	GGCTTCACATATGTATTGTTCTTTCTACCC	3127	1	1.0	TACCAAGGTAAACCTTTGGAATTTGGTGCC	1	1.0	TCCAGATGAGGATGAAGAAGAAGGTGAT	{3042}
2.8686666660097973	3637	3782	145	3637	1	1.0	GGTGAAGACATTCAACTTCTTAAGAGTGCT	3752	1	1.0	GAGTTTGTGTAGATACTGTTCGCACAAATG	1	1.0	AATTTTAATCAGCACGAAGTTCTACTTG	{3673}
2.8724160284948064	80	226	146	80	1	1.0	AATCTGTGTGGCTGTCACTCGGCTGCATGC	196	1	1.0	CGGTTTCGTCCGTGTTGCAGCCGATCATCA	1	1.0	ACGCAGTATAATTAATAACTAATTACTG	{121}
2.8724160284948064	2055	2201	146	2055	1	1.0	AATGGCCTACATTACAGGTGGTGTTGTTCA	2171	1	1.0	AGGAAGGTGTAGAGTTTCTTAGAGACGGTT	1	1.0	GTTGACTTCGCAGTGGCTAACTAACATC	{2085}
2.8724160284948064	12797	12943	146	12797	1	1.0	GTAGGTTTGTACTTGCACTGTTATCCGATT	12913	1	1.0	ACAGACACACCTAAAGGTCCTAAAGTGAAG	1	1.0	TACAGGATTTGAAATGGGCTAGATTCCC	{12827}
2.8724160284948064	22093	22239	146	22093	1	1.0	GGACCTTGAAGGAAAACAGGGTAATTTCAA	22209	1	1.0	TCCCTCAGGGTTTTTCGGCTTTAGAACCAT	1	1.0	AAATCTTAGGGAATTTGTGTTTAAGAAT	{22123}
2.8724160284948064	25699	25845	146	25699	1	1.0	GCCCCTTTTCTCTATCTTTATGCTTTAGTC	25815	1	1.0	TGATGCCAACTATTTTCTTTGCTGGCATAC	1	1.0	TGTAAGAATAATAATGAGGCTTTGGCTT	{25752}
2.876122044777587	13407	13554	147	13407	1	1.0	TAGTTGTGATCAACTCCGCGAACCCATGCT	13524	1	1.0	GATGTCGTATACAGGGCTTTTGACATCTAC	1	1.0	TCAGTCAGCTGATGCACAATCGTTTTTA	{13437}
2.876122044777587	15705	15852	147	15705	1	1.0	ATGATACTCTCTGACGATGCTGTTGTGTGT	15822	1	1.0	TCTGAAGCAAAATGTTGGACTGAGACTGAC	1	1.0	TTCAATAGCACTTATGCATCTCAAGGTC	{15735}
2.876122044777587	20169	20316	147	20169	1	1.0	GGTGTTGTCCAACAATTACCTGAAACTTAC	20286	1	1.0	GAACGGTATAAATTAGAAGGCTATGCCTTC	1	1.0	CTCAGAGTAGAAATTTACAAGAATTTAA	{20203}
2.876122044777587	24720	24867	147	24720	1	1.0	CTCAGTCAGCACCTCATGGTGTAGTCTTCT	24837	1	1.0	AAGGTGTCTTTGTTTCAAATGGCACACACT	1	1.0	TGCATGTGACTTATGTCCCTGCACAAGA	{24750}
2.8797857056612073	19472	19620	148	19472	1	1.0	TTTAGGTGGTGCTGTCTGTAGACATCATGC	19590	1	1.0	AACCTCTGGAACACTTTTACAAGACTTCAG	1	1.0	TAATGAGTACAGATTGTATCTCGATGCT	{19502}
2.8797857056612073	23749	23897	148	23749	1	1.0	GTCTATGACCAAGACATCAGTAGATTGTAC	23867	1	1.0	GGAATAGCTGTTGAACAAGACAAAAACACC	1	1.0	TGATTCAACTGAATGCAGCAATCTTTTG	{23794}
2.8834079683607334	8801	8950	149	8801	1	1.0	CTAATGACAAAGCTTGCCCATTGATTGCTG	8920	1	1.0	CCTAGAGTTTTTAGTGCAGTTGGTAACATC	1	1.0	CAGTCATAACAAGAGAAGTGGGTTTTGT	{8831}
2.8834079683607334	10187	10336	149	10187	1	1.0	CCTCTGAAGACATGCTTAACCCTAATTATG	10306	1	1.0	TGTGTACTTAAGCTTAAGGTTGATACAGCC	1	1.0	TCGTAAGTCTAATCATAATTTCTTGGTA	{10230}
2.8834079683607334	25927	26076	149	25927	1	1.0	ATTTCTGAACATGACTACCAGATTGGTGGT	26046	1	1.0	ATTGAGTACAGACACTGGTGTTGAACATGT	1	1.0	TATACTGAAAAATGGGAATCTGGAGTAA	{25957}
2.8869897580044537	4067	4217	150	4067	1	1.0	CCACTCTTGTTAGTGACATTGACATCACTT	4187	1	1.0	GCACTACTGAAATGCTAGCGAAAGCTTTGA	1	1.0	TAGTGGGTGATGTTGTTCAAGAGGGTGT	{4121}
2.8869897580044537	4106	4256	150	4106	1	1.0	AAGATGCTCCATATATAGTGGGTGATGTTG	4226	1	1.0	CAACAGACAATTATATAACCACTTACCCGG	1	1.0	TTCAAGAGGGTGTTTTAACTGCTGTGGT	{4136}
2.8869897580044537	11816	11966	150	11816	1	1.0	CTTGTATCAAAGTAGCCACTGTACAGTCTA	11936	1	1.0	GTGTCCAGTTACACAATGACATTCTCTTAG	1	1.0	TCAGATGTAAAGTGCACATCAGTAGTCT	{11851}
2.8869897580044537	18026	18176	150	18026	1	1.0	GGCAACTTTACAAGCTGAAAATGTAACAGG	18146	1	1.0	AGGTTTATGTGTTGACATACCTGGCATACC	1	1.0	AAAGATTGTAGTAAGGTAATCACTGGGT	{18063}
2.8905319690521503	14215	14366	151	14215	1	1.0	CTGACTTAACAAAGCCTTACATTAAGTGGG	14336	1	1.0	TAACTGTTTGGATGACAGATGCATTCTGCA	1	1.0	TTCACGGAAGAGAGGTTAAAACTCTTTG	{14262}
2.8905319690521503	16522	16673	151	16522	1	1.0	CATGTGTTGGTAGCGATAATGTTACTGACT	16643	1	1.0	AACGCTCAAAGCTACTGAGGAGACATTTAA	1	1.0	GACAAATGCTGGTGATTACATTTTAGCT	{16577}
2.8905319690521503	19177	19328	151	19177	1	1.0	GTGTATGCCTATTTTGGAATTGCAATGTCG	19298	1	1.0	TGTAAATAAACATGCATTCCACACACCAGC	1	1.0	ATAGATATCCTGCTAATTCCATTGTTTG	{19207}
2.8940354666358683	24168	24320	152	24168	1	1.0	TGATTGCTCAATACACTTCTGCACTGTTAG	24290	1	1.0	GGAGTTACACAGAATGTTCTCTATGAGAAC	1	1.0	CGGGTACAATCACTTCTGGTTGGACCTT	{24198}
2.8940354666358683	25222	25374	152	25222	1	1.0	TATAGCTGGCTTGATTGCCATAGTAATGGT	25344	1	1.0	CTGAGCCAGTGCTCAAAGGAGTCAAATTAC	1	1.0	GACAATTATGCTTTGCTGTATGACCAGT	{25252}
2.900929642842771	18937	19091	154	18937	1	1.0	GTGATGAACTGAAGATTAATGCGGCTTGTA	19061	1	1.0	ACCTCAAGCTGATGTAGAATGGAAGTTCTA	1	1.0	GAAAGGATCAACACATGGTTGTTAAAGC	{18967}
2.900929642842771	19953	20107	154	19953	1	1.0	ACTGAAACGATTTGTGCACCACTCACTGTC	20077	1	1.0	CATCTGTAGGTCCCAAACAAGCTAGTCTTA	1	1.0	AATGGTGTTCTTATTACAGAAGGTAGTG	{20034}
2.900929642842771	23598	23752	154	23598	1	1.0	ATTCTCCTCGGCGGGCACGTAGTGTAGCTA	23722	1	1.0	TAGTGTTACCACAGAAATTCTACCAGTGTC	1	1.0	GTCAATCCATCATTGCCTACACTATGTC	{23628}
2.9043219161711367	15335	15490	155	15335	1	1.0	TATGGCCTCACTTGTTCTTGCTCGCAAACA	15460	1	1.0	ATGTTAAACCAGGTGGAACCTCATCAGGAG	1	1.0	TACAACGTGTTGTAGCTTGTCACACCGT	{15365}
2.9043219161711367	19801	19956	155	19801	1	1.0	GCAACATTAAACCAGTACCAGAGGTGAAAA	19926	1	1.0	TCTATGACTGACATAGCCAAGAAACCAACT	1	1.0	AGCACATATATCTACTATTGGTGTTTGT	{19898}
2.9043219161711367	28343	28498	155	28343	1	1.0	ACTGGCAGTAACCAGAATGGAGAACGCAGT	28468	1	1.0	ATTCCCTCGAGGACAAGGCGTTCCAATTAA	1	1.0	GGGGCGCGATCAAAACAACGTCGGCCCC	{28373}
2.907678667660241	19395	19551	156	19395	1	1.0	GAGTCTCATGGAAAACAAGTAGTGTCAGAT	19521	1	1.0	CTCGATGCTTATAACATGATGATCTCAGCT	1	1.0	ACATCATGCTAATGAGTACAGATTGTAT	{19493}
2.907678667660241	27661	27817	156	27661	1	1.0	CAAGAGGAAGTTCAAGAACTTTACTCTCCA	27787	1	1.0	TGTGCTTTTTAGCCTTTCTGCTATTCCTTG	1	1.0	ATTTTTCTTATTGTTGCGGCAATAGTGT	{27691}
2.91100063353398	6301	6458	157	6301	1	1.0	CTTTGGAGCACAAAACCAGTTGAAACATCA	6428	1	1.0	CTACCATACAGAAAGACGTTCTTGAGTGTA	1	1.0	GTTTGATGTACTGAAGTCAGAGGACGCG	{6336}
2.91100063353398	11262	11419	157	11262	1	1.0	GTTGGATATGGTTGATACTAGTTTGTCTGG	11389	1	1.0	TGGACACTTATGAATGTCTTGACACTCGTT	1	1.0	TGTGTATGATGATGGTGCTAGGAGAGTG	{11361}
2.9142885273623995	1915	2073	158	1915	1	1.0	ACTCTTGAAACTGCTCAAAATTCTGTGCGT	2043	1	1.0	CAATCTAGTTGTAATGGCCTACATTACAGG	1	1.0	GTTTTACAGAAGGCCGCTATAACAATAC	{1945}
2.917543040981689	20030	20189	159	20030	1	1.0	CCGTAATGGTGTTCTTATTACAGAAGGTAG	20159	1	1.0	GAAAGTTGATGGTGTTGTCCAACAATTACC	1	1.0	TGTTAAAGGTTTACAACCATCTGTAGGT	{20060}
2.917543040981689	20473	20632	159	20473	1	1.0	CAGGTTCATCTAAGTGTGTGTGTTCTGTTA	20602	1	1.0	CATTTATGCTTTGGTGTAAAGATGGCCATG	1	1.0	ATCTGTAGTTTCTAAGGTTGTCAAAGTG	{20552}
2.917543040981689	22638	22797	159	22638	1	1.0	GCAACTGTGTTGCTGATTATTCTGTCCTAT	22767	1	1.0	TTAGAGGTGATGAAGTCAGACAAATCGCTC	1	1.0	ATTCCGCATCATTTTCCACTTTTAAGTG	{22671}
2.920764845367944	19893	20053	160	19893	1	1.0	GCTCCAGCACATATATCTACTATTGGTGTT	20023	1	1.0	GAAATGCCCGTAATGGTGTTCTTATTACAG	1	1.0	ACATAGACAAGAAACCAACTGAAACGAT	{19936}
2.923954591467449	11326	11487	161	11326	1	1.0	GCTGTAGTGTTACTAATCCTTATGACAGCA	11457	1	1.0	TTCCATGTGGGCTCTTATAATCTCTGTTAC	1	1.0	TGTGTATGATGATGGTGCTAGGAGAGTG	{11361}
2.927112910986066	23126	23288	162	23126	1	1.0	GCAACTGTTTGTGGACCTAAAAAGTCTACT	23258	1	1.0	GGCAGAGACATTGCTGACACTACTGATGCT	1	1.0	ATTTGGTTAAAAACAAATGTGTCAATTT	{23157}
2.930240417140111	454	617	163	454	1	1.0	CTTGAACAGCCCTATGTGTTCATCAAACGT	587	1	1.0	TCCCTCATGTGGGCGAAATACCAGTGGCTT	1	1.0	TCGGATGCTCGAACTGCACCTCATGGTC	{484}
2.930240417140111	22458	22621	163	22458	1	1.0	CAAAGTGTACGTTGAAATCCTTCACTGTAG	22591	1	1.0	CGCCACCAGATTTGCATCTGTTTATGCTTG	1	1.0	ACTTCTAACTTTAGAGTCCAACCAACAG	{22505}
2.9364053540254123	3727	3892	165	3727	1	1.0	GGTGCTGACCCTATACATTCTTTAAGAGTT	3862	1	1.0	GAACAAAAGATCGCTGAGATTCCTAAAGAG	1	1.0	GTAGATACTGTTCGCACGAATGTCTACT	{3760}
2.9364053540254123	14121	14286	165	14121	1	1.0	GGTAGTGGAGTTCCTGTTGTAGATTCTTAT	14256	1	1.0	TATGACTTCACGGAAGAGAGGTTAAAACTC	1	1.0	TATTCATTGTTAATGCCTATATTAACCT	{14151}
2.9364053540254123	22797	22962	165	22797	1	1.0	CAGGGCAAACTGGAAAGATTGCTGATTATA	22932	1	1.0	GGAAGTCTAATCTCAAACCTTTTGAGAGAG	1	1.0	CTGCGTTATAGCTTGGAATTCTAACAAT	{22855}
2.9364053540254123	22854	23019	165	22854	1	1.0	GCTGCGTTATAGCTTGGAATTCTAACAATC	22989	1	1.0	GTAGCACACCTTGTAATGGTGTTGAAGGTT	1	1.0	GATTCTAAGGTTGGTGGTAATTATAATT	{22886}
2.9364053540254123	27933	28098	165	27933	1	1.0	GCTGCATTTCACCAAGAATGTAGTTTACAG	28068	1	1.0	GAATTGTGCGTGGATGAGGCTGGTTCTAAA	1	1.0	CCCGTGTCCTATTCACTTCTATTCTAAA	{27998}
2.939443925003943	14487	14653	166	14487	1	1.0	GAGCTAGGTGTTGTACATAATCAGGATGTA	14623	1	1.0	GCTTTTCAGTAGCTGCACTTACTAACAATG	1	1.0	CATAGCTCTAGACTTAGTTTTAAGGAAT	{14523}
2.939443925003943	25816	25982	166	25816	1	1.0	GATGCCAACTATTTTCTTTGCTGGCATACT	25952	1	1.0	GTGGTTATACTGAAAAATGGGAATCTGGAG	1	1.0	GTGTAACTTCTTCAATTGTCATTACTTC	{25877}
2.939443925003943	27213	27379	166	27213	1	1.0	CGTTGACTTTCAGGTTACTATAGCAGAGAT	27349	1	1.0	TCTCAATTAGATGAAGAGCAACCAATGGAG	1	1.0	ATTAAAAATTTATCTAAGTCACTAACTG	{27310}
2.9424539643783345	17963	18130	167	17963	1	1.0	GTCTGATAGAGACCTTTATGACAAGTTGCA	18100	1	1.0	CACAGGCACCTACACACCTCAGTGTTGACA	1	1.0	TTACAAGTCTTGAAATTCCACGTAGGAA	{17995}
2.9454360029807227	18902	19070	168	18902	1	1.0	GCGTGTTGACTGGACTATTGAATATCCTAT	19040	1	1.0	CCCTAAAGCTATTAAGTGTGTACCTCAAGC	1	1.0	TGAAGATTAATGCGGCTTGTAGAAAGGA	{18946}
2.9454360029807227	25349	25517	168	25349	1	1.0	CCAGTGCTCAAAGGAGTCAAATTACATTAC	25487	1	1.0	CTGCAACGATACCGATACAAGCCTCACTCC	1	1.0	AGAATCTTCATAATTGGAACTGTAACTT	{25408}
2.9542192055029934	18499	18670	171	18499	1	1.0	ACAAAGGACTTCCTTGGAATGTAGTGCGTA	18640	1	1.0	TAGGACCTGAGCGCACCTGTTGTCTATGTG	1	1.0	TGAGTTGACATCTATGAAGTATTTTGTG	{18608}
2.9570942636811997	1056	1228	172	1056	1	1.0	CACCTTCAATGGGGAATGTCCAAATTTTGT	1198	1	1.0	TGCAACCAAATGTGCCTTTCAACTCTCATG	1	1.0	ATTTCCCTTAAATTCCATAATCAAGACT	{1086}
2.9570942636811997	12466	12638	172	12466	1	1.0	GCCAAACTAATGGTTGTCATACCAGACTAT	12608	1	1.0	GTATGGACAATTCACCTAATTTAGCATGGC	1	1.0	ACACATATAAAAATACGTGTGATGGTAC	{12497}
2.9570942636811997	14406	14578	172	14406	1	1.0	CCTACAAGTTTTGGACCACTAGTGAGAAAA	14548	1	1.0	AATTACTTGTGTATGCTGCTGACCCTGCTA	1	1.0	GTAAACTTACATAGCTCTAGACTTAGTT	{14514}
2.9570942636811997	16116	16288	172	16116	1	1.0	GATGAGTTAACAGGACACATGTTAGACATG	16258	1	1.0	GCAATTCACAGACTTCATTAAGATGTGGTG	1	1.0	CTTACAGGCTGTTGGGGCTTGTGTTCTT	{16229}
2.9570942636811997	25621	25793	172	25621	1	1.0	GTTCACTTTGTTTGCAACTTGCTGTTGTTG	25763	1	1.0	TAATGAGGCTTTGGCTTTGCTGGAAATGCC	1	1.0	TGAAGCCCCTTTTCTCTATCTTTATGCT	{25695}
2.9627681611474057	8714	8888	174	8714	1	1.0	CTCGTGACATAGCATCTACAGATACTTGTT	8858	1	1.0	TCGTGCCTGGTTTGCCTGGCACGATATTAC	1	1.0	GCAGTCATAACAAGAGAAGTGGGTTTTG	{8830}
2.9627681611474057	15599	15773	174	15599	1	1.0	CCGCAATTTACAACACAGACTTTATGAGTG	15743	1	1.0	CACTTATGCATCTCAAGGTCTAGTGGCTAG	1	1.0	CTATAGAAATAGAGATGTTGACACAGAC	{15632}
2.96556788931984	3012	3187	175	3012	1	1.0	GGCTTCACATATGTATTGTTCTTTCTACCC	3157	1	1.0	ACTTCTGCTGCTCTTCAACCTGAAGAAGAG	1	1.0	TCCAGATGAGGATGAAGAAGAAGGTGAT	{3042}
2.96556788931984	17881	18056	175	17881	1	1.0	CCACTGAAACAGCTCACTCTTGTAATGTAA	18026	1	1.0	GGCAACTTTACAAGCTGAAAATGTAACAGG	1	1.0	TTACAAGTCTTGAAATTCCACGTAGGAA	{17995}
2.96556788931984	23893	24068	175	23893	1	1.0	CACCCAAGAAGTTTTTGCACAAGTCAAACA	24038	1	1.0	GTGACACTTGCAGATGCTGGCTTCATCAAA	1	1.0	ACCAGATCCATCAAAACCAAGCAAGAGG	{23980}
2.9683433771173466	80	256	176	80	1	1.0	AATCTGTGTGGCTGTCACTCGGCTGCATGC	226	1	1.0	GCACATCTAGGTTTCGTCCGGGTGTGACCG	1	1.0	ACGCAGTATAATTAATAACTAATTACTG	{121}
2.9683433771173466	9066	9242	176	9066	1	1.0	TGATACCAATGTACTAGAAGGTTCTGTTGC	9212	1	1.0	ACTGTAGGCACGGCACTTGTGAAAGATCAG	1	1.0	TTATGAAAGTTTACGCCCTGACACACGT	{9096}
2.9683433771173466	11883	12059	176	11883	1	1.0	CTCAGTTTTGCAACAACTCAGAGTAGAATC	12029	1	1.0	AGGGTGCTGTAGACATAAACAAGCTTTGTG	1	1.0	ATCTAAATTGTGGGCTCAATGTGTCCAG	{11916}
2.973823285568201	18711	18889	178	18711	1	1.0	GCCTGTTGGCATCATTCTATTGGATTTGAT	18859	1	1.0	CAATCATGACTAGGTGTCTAGCTGTCCACG	1	1.0	TCTGTATTGTCAAGTCCATGGTAATGCA	{18812}
2.9765285070070253	8487	8666	179	8487	1	1.0	GTTGACATGTGCAACTACTAGACAAGTTGT	8636	1	1.0	CACCTGTTCATGTCATGTCTAAACATACTG	1	1.0	AAAGTTACACTTGTGTTCCTTTTTGTTG	{8587}
2.9765285070070253	22687	22866	179	22687	1	1.0	CACTTTTAAGTGTTATGGAGTGTCTCCTAC	22836	1	1.0	TACCAGATGATTTTACAGGCTGCGTTATAG	1	1.0	CAGATTCATTTGTAATTAGAGGTGATGA	{22752}
2.979211090344213	4106	4286	180	4106	1	1.0	AAGATGCTCCATATATAGTGGGTGATGTTG	4256	1	1.0	GTCAGGGTTTAAATGGTTACACTGTAGAGG	1	1.0	TTCAAGAGGGTGTTTTAACTGCTGTGGT	{4136}
2.979211090344213	18026	18206	180	18026	1	1.0	GGCAACTTTACAAGCTGAAAATGTAACAGG	18176	1	1.0	TAAGGACATGACCTATAGAAGACTCATCTC	1	1.0	AAAGATTGTAGTAAGGTAATCACTGGGT	{18063}
2.979211090344213	19095	19275	180	19095	1	1.0	GCACAGCCTTGTAGTGACAAAGCTTATAAA	19245	1	1.0	ACTAGAGTGCTATCTAACCTTAACTTGCCT	1	1.0	GTCGATAGATATCCTGCTAATTCCATTG	{19203}
2.9818714113224147	9781	9962	181	9781	1	1.0	AGTACTTTTGAAGAAGCTGCGCTGTGCACC	9932	1	1.0	CAACTAGCTACAGAGAAGCTGCTTGTTGTC	1	1.0	TATCTAAAGTTGCGTAGTGATGTGCTAT	{9832}
2.9818714113224147	29231	29412	181	29231	1	1.0	ATTGGCATGGAAGTCACACCTTCGGGAACG	29382	1	1.0	AGGACAAAAAGAAGAAGGCTGATGAAACTC	1	1.0	TGGTTGACCTACACAGGTGCCATCAAAT	{29261}
2.9845098364064735	14034	14216	182	14034	1	1.0	GCTGGTATTGTTGGTGTACTGACATTAGAT	14186	1	1.0	GGCTTTAACTGCAGAGTCACATGTTGACAC	1	1.0	ACCACGCCAGGTAGTGGAGTTCCTGTTG	{14112}
2.9845098364064735	16522	16704	182	16522	1	1.0	CATGTGTTGGTAGCGATAATGTTACTGACT	16674	1	1.0	CTGTCTTATGGTATTGCTACTGTACGTGAA	1	1.0	GACAAATGCTGGTGATTACATTTTAGCT	{16577}
2.9845098364064735	23678	23860	182	23678	1	1.0	GCTTACTCTAATAACTCTATTGCCATACCC	23830	1	1.0	TGGCAGTTTTTGTACACAATTAAACCGTGC	1	1.0	TAGTGTTACCACAGAAATTCTACCAGTG	{23722}
2.9897224201679635	18937	19121	184	18937	1	1.0	GTGATGAACTGAAGATTAATGCGGCTTGTA	19091	1	1.0	TGATGCACAGCCTTGTAGTGACAAAGCTTA	1	1.0	GAAAGGATCAACACATGGTTGTTAAAGC	{18967}
2.9897224201679635	19953	20137	184	19953	1	1.0	ACTGAAACGATTTGTGCACCACTCACTGTC	20107	1	1.0	ATGGAGTCACATTAATTGGAGAAGCCGTAA	1	1.0	AATGGTGTTCTTATTACAGAAGGTAGTG	{20034}
2.9897224201679635	27877	28061	184	27877	1	1.0	GTCACGCCTAAACGAACATGAAATTTCTTG	28031	1	1.0	TATTAGAGTAGGAGCTAGAAAATCAGCACC	1	1.0	CCCGTGTCCTATTCACTTCTATTCTAAA	{27998}
2.992297268051916	12553	12738	185	12553	1	1.0	GAAATCCAACAGGTTGTAGATGCAGATAGT	12708	1	1.0	ACTACGACAGATGTCTTGTGCTGCCGGTAC	1	1.0	TAGTATGGACAATTCACCTAATTTAGCA	{12606}
2.992297268051916	21904	22089	185	21904	1	1.0	CCAGTCCCTACTTATTGTTAATAACGCTAC	22059	1	1.0	GCACTTTTGAATATGTCTCTCAGCCTTTTC	1	1.0	TAATGTTGTTATTAAAGTCTGTGAATTT	{21934}
2.992297268051916	28343	28528	185	28343	1	1.0	ACTGGCAGTAACCAGAATGGAGAACGCAGT	28498	1	1.0	CACCAATAGCAGTCCAGATGACCAAATTGG	1	1.0	GGGGCGCGATCAAAACAACGTCGGCCCC	{28373}
2.9948515990016813	3310	3496	186	3310	1	1.0	CTTACACCAGTTGTTCAGACTATTGAAGTG	3466	1	1.0	GGAGGAGGTGTTGCAGGAGCCTTAAATAAG	1	1.0	AATAGTTTTAGTGGTTATTTAAAACTTA	{3340}
2.9948515990016813	8524	8710	186	8524	1	1.0	GTAACAACAAAGATAGCACTTAAGGGTGGT	8680	1	1.0	ATCATAGGATACAAGGCTATTGATGGTGGT	1	1.0	AAAGTTACACTTGTGTTCCTTTTTGTTG	{8587}
2.9948515990016813	22022	22208	186	22022	1	1.0	GAAAGTGAGTTCAGAGTTTATTCTAGTGCG	22178	1	1.0	AAGCACACGCCTATTAATTTAGTGCGTGAT	1	1.0	TTGCACTTTTGAATATGTCTCTCAGCCT	{22057}
2.997385737400775	4067	4254	187	4067	1	1.0	CCACTCTTGTTAGTGACATTGACATCACTT	4224	1	1.0	GCCAACAGACAATTATATAACCACTTACCC	1	1.0	TAGTGGGTGATGTTGTTCAAGAGGGTGT	{4121}
2.997385737400775	6301	6488	187	6301	1	1.0	CTTTGGAGCACAAAACCAGTTGAAACATCA	6458	1	1.0	ATGTGAAAACTACCGAAGTTGTAGGAGACA	1	1.0	GTTTGATGTACTGAAGTCAGAGGACGCG	{6336}
2.997385737400775	27999	28186	187	27999	1	1.0	CCGTGTCCTATTCACTTCTATTCTAAATGG	28156	1	1.0	TTAATTGCCAGGAACCTAAATTGGGTAGTC	1	1.0	TATCGGTAATTATACAGTTTCCTGTTTA	{28118}
3.0023946961550467	22638	22827	189	22638	1	1.0	GCAACTGTGTTGCTGATTATTCTGTCCTAT	22797	1	1.0	CAGGGCAAACTGGAAAGATTGCTGATTATA	1	1.0	ATTCCGCATCATTTTCCACTTTTAAGTG	{22671}
3.0048701280549226	17244	17434	190	17244	1	1.0	CGTGCTCGTGTAGAGTGTTTTGATAAATTC	17404	1	1.0	GATTACGTGCTAAGCACTATGTGTACATTG	1	1.0	TTGTACTGTAAATGCATTGCCTGAGACG	{17306}
3.0073265909416214	11938	12129	191	11938	1	1.0	GTCCAGTTACACAATGACATTCTCTTAGCT	12099	1	1.0	CTCAGAGTTTAGTTCCCTTCCATCATATGC	1	1.0	AAACAAGCTTTGTGAAGAAATGCTGGAC	{12045}
3.0073265909416214	20169	20360	191	20169	1	1.0	GGTGTTGTCCAACAATTACCTGAAACTTAC	20330	1	1.0	TGGAGATTTTAGTCATAGTCAGTTAGGTGG	1	1.0	CTCAGAGTAGAAATTTACAAGAATTTAA	{20203}
3.0073265909416214	26452	26643	191	26452	1	1.0	GTTCCTGATCTTCTGGTCTAAACGAACTAA	26613	1	1.0	TGGATTTGTCTTCTACAATTTGCCTATGCC	1	1.0	TAGCCATGGCAGATTCCAACGGTACTAT	{26518}
3.0097643733214485	23126	23318	192	23126	1	1.0	GCAACTGTTTGTGGACCTAAAAAGTCTACT	23288	1	1.0	GTCCGTGATCCACAGACACTTGAGATTCTT	1	1.0	ATTTGGTTAAAAACAAATGTGTCAATTT	{23157}
3.0121837571683643	454	647	193	454	1	1.0	CTTGAACAGCCCTATGTGTTCATCAAACGT	617	1	1.0	ACCGCAAGGTTCTTCTTCGTAAGAACGGTA	1	1.0	TCGGATGCTCGAACTGCACCTCATGGTC	{484}
3.0121837571683643	3875	4068	193	3875	1	1.0	CTGAGATTCCTAAAGAGGAAGTTAAGCCAT	4038	1	1.0	CATTAATGGCAATCTTCATCCAGATTCTGC	1	1.0	TTCAGTTGAACAGAGAAAACAAGATGAT	{3924}
3.0121837571683643	4433	4626	193	4433	1	1.0	CTGTCTGTGTGGAAACTAAAGCCATAGTTT	4596	1	1.0	TCTTGTTACAATGCCACTTGGCTATGTAAC	1	1.0	CAACTATACAGCGTAAATATAAGGGTAT	{4463}
3.0121837571683643	22458	22651	193	22458	1	1.0	CAAAGTGTACGTTGAAATCCTTCACTGTAG	22621	1	1.0	GAACAGGAAGAGAATCAGCAACTGTGTTGC	1	1.0	ACTTCTAACTTTAGAGTCCAACCAACAG	{22505}
3.014585018119717	16211	16405	194	16211	1	1.0	GTACACACCGCATACAGTCTTACAGGCTGT	16375	1	1.0	CGTATGTTTGCAATGCTCCAGGTTGTGATG	1	1.0	TGGGGCTTGTGTTCTTTGCAATTCACAG	{16241}
3.014585018119717	27454	27648	194	27454	1	1.0	CAAGAGTGTGTTAGAGGTACAACAGTACTT	27618	1	1.0	TCAGTTACGTGCCAGATCAGTTTCACCTAA	1	1.0	CTTGTCCTGACGGCGTAAAACACGTCTA	{27590}
3.0169684256646945	27933	28128	195	27933	1	1.0	GCTGCATTTCACCAAGAATGTAGTTTACAG	28098	1	1.0	TCACCCATTCAGTACATCGATATCGGTAAT	1	1.0	CCCGTGTCCTATTCACTTCTATTCTAAA	{27998}
3.0193342433258255	994	1190	196	994	1	1.0	CGTTCTGAAAAGAGCTATGAATTGCAGACA	1160	1	1.0	GAATTCGATCTGTCTATCCAGTTGCGTCAC	1	1.0	ATTTCCCTTAAATTCCATAATCAAGACT	{1086}
3.0193342433258255	14215	14411	196	14215	1	1.0	CTGACTTAACAAAGCCTTACATTAAGTGGG	14381	1	1.0	TGTTTTATTCTCTACAGTGTTCCCACCTAC	1	1.0	TTCACGGAAGAGAGGTTAAAACTCTTTG	{14262}
3.0193342433258255	16479	16675	196	16479	1	1.0	CCATTGTGTGCTAATGGACAAGTTTTTGGT	16645	1	1.0	CGCTCAAAGCTACTGAGGAGACATTTAAAC	1	1.0	GACAAATGCTGGTGATTACATTTTAGCT	{16577}
3.0193342433258255	22797	22993	196	22797	1	1.0	CAGGGCAAACTGGAAAGATTGCTGATTATA	22963	1	1.0	TATTTCAACTGAAATCTATCAGGCCGGTAG	1	1.0	CTGCGTTATAGCTTGGAATTCTAACAAT	{22855}
3.024014134296109	25349	25547	198	25349	1	1.0	CCAGTGCTCAAAGGAGTCAAATTACATTAC	25517	1	1.0	CTTTCGGATGGCTTATTGTTGGCGTTGCAC	1	1.0	AGAATCTTCATAATTGGAACTGTAACTT	{25408}
3.026328706359163	8801	9000	199	8801	1	1.0	CTAATGACAAAGCTTGCCCATTGATTGCTG	8970	1	1.0	TATAGAGTACACTGACTTTGCAACATCAGC	1	1.0	CAGTCATAACAAGAGAAGTGGGTTTTGT	{8831}
3.026328706359163	18902	19101	199	18902	1	1.0	GCGTGTTGACTGGACTATTGAATATCCTAT	19071	1	1.0	GATGTAGAATGGAAGTTCTATGATGCACAG	1	1.0	TGAAGATTAATGCGGCTTGTAGAAAGGA	{18946}
3.026328706359163	25927	26126	199	25927	1	1.0	ATTTCTGAACATGACTACCAGATTGGTGGT	26096	1	1.0	AAATTGTTGATGAGCCTGAAGAACATGTCC	1	1.0	TATACTGAAAAATGGGAATCTGGAGTAA	{25957}
3.030908310503012	15541	15742	201	15541	1	1.0	CGGCCAATGTTAATGCACTTTTATCTACTG	15712	1	1.0	TCTCTGACGATGCTGTTGTGTGTTTCAATA	1	1.0	CTATAGAAATAGAGATGTTGACACAGAC	{15632}
3.030908310503012	18499	18700	201	18499	1	1.0	ACAAAGGACTTCCTTGGAATGTAGTGCGTA	18670	1	1.0	ATAGACGTGCCACATGCTTTTCCACTGCTT	1	1.0	TGAGTTGACATCTATGAAGTATTTTGTG	{18608}
3.030908310503012	20473	20674	201	20473	1	1.0	CAGGTTCATCTAAGTGTGTGTGTTCTGTTA	20644	1	1.0	ACCCAAAATTACAATCTAGTCAAGCGTGGC	1	1.0	ATCTGTAGTTTCTAAGGTTGTCAAAGTG	{20552}
3.0331738099539405	1056	1258	202	1056	1	1.0	CACCTTCAATGGGGAATGTCCAAATTTTGT	1228	1	1.0	AAGTGTGATCATTGTGGTGAAACTTCATGG	1	1.0	ATTTCCCTTAAATTCCATAATCAAGACT	{1086}
3.0331738099539405	11326	11528	202	11326	1	1.0	GCTGTAGTGTTACTAATCCTTATGACAGCA	11498	1	1.0	CAGGTGTAGTTACAACTGTCATGTTTTTGG	1	1.0	TGTGTATGATGATGGTGCTAGGAGAGTG	{11361}
3.0331738099539405	14406	14608	202	14406	1	1.0	CCTACAAGTTTTGGACCACTAGTGAGAAAA	14578	1	1.0	TGCACGCTGCTTCTGGTAATCTATTACTAG	1	1.0	GTAAACTTACATAGCTCTAGACTTAGTT	{14514}
3.0331738099539405	15705	15907	202	15705	1	1.0	ATGATACTCTCTGACGATGCTGTTGTGTGT	15877	1	1.0	GCTCTCAACATACAATGCTAGTTAAACAGG	1	1.0	TTCAATAGCACTTATGCATCTCAAGGTC	{15735}
3.0331738099539405	21423	21625	202	21423	1	1.0	GGGTACTGCTGTTATGTCTTTAAAAGAAGG	21595	1	1.0	CTCTAGTCAGTGTGTTAATCTTACAACCAG	1	1.0	TTGTTAACAACTAAACGAACAATGTTTG	{21542}
3.035423411032158	6552	6755	203	6552	1	1.0	GGCTGCTTATGTAGACAATTCTAGTCTTAC	6725	1	1.0	CTAACATAGTTACACGGTGTTTAAACCGTG	1	1.0	ACCCTTGCTACTCATGGTTTAGCTGCTG	{6625}
3.035423411032158	18187	18390	203	18187	1	1.0	CCTATAGAAGACTCATCTCTATGATGGGTT	18360	1	1.0	CAGCTAGGTTTTTCTACAGGTGTTAACCTA	1	1.0	GCGAAGAAGCTATAAGACATGTACGTGC	{18265}
3.035423411032158	28099	28302	203	28099	1	1.0	CACCCATTCAGTACATCGATATCGGTAATT	28272	1	1.0	AAATGTCTGATAATGGACCCCAAAATCAGC	1	1.0	CTAAATTGGGTAGTCTTGTAGTGCGTTG	{28171}
3.0376573353204814	3216	3420	204	3216	1	1.0	TCAACAAACTGTTGGTCAACAAGACGGCAG	3390	1	1.0	TGCAGACATTGTGGAAGAAGCTAAAAAGGT	1	1.0	CCTCAATTAGAGATGGAACTTACACCAG	{3292}
3.0376573353204814	27661	27865	204	27661	1	1.0	CAAGAGGAAGTTCAAGAACTTTACTCTCCA	27835	1	1.0	TCTTTTGGTTCTCACTTGAACTGCAAGATC	1	1.0	ATTTTTCTTATTGTTGCGGCAATAGTGT	{27691}
3.0398757998013184	23893	24098	205	23893	1	1.0	CACCCAAGAAGTTTTTGCACAAGTCAAACA	24068	1	1.0	CAATATGGTGATTGCCTTGGTGATATTGCT	1	1.0	ACCAGATCCATCAAAACCAAGCAAGAGG	{23980}
