cost	target-start	target-end	target-length	left-primer-start	left-primer-num-primers	left-primer-frac-bound	left-primer-target-sequences	right-primer-start	right-primer-num-primers	right-primer-frac-bound	right-primer-target-sequences	num-guides	total-frac-bound-by-guides	guide-target-sequences	guide-target-sequence-positions
2.5126942636811997	16206	16294	88	16206	1	1.0	GCTATGTACACACCGCATACAGTCTTACAG	16264	1	1.0	CACAGACTTCATTAAGATGTGGTGCTTGCA	1	1.0	GCTGTTGGGGCTTGTGTTCTTTGCAATT	{16236}
2.5126942636811997	19472	19560	88	19472	1	1.0	TTTAGGTGGTGCTGTCTGTAGACATCATGC	19530	1	1.0	TATAACATGATGATCTCAGCTGGCTTTAGC	1	1.0	TAATGAGTACAGATTGTATCTCGATGCT	{19502}
2.5126942636811997	19869	19957	88	19869	1	1.0	GTGATCTGGGACTACAAAAGAGATGCTCCA	19927	1	1.0	CTATGACTGACATAGCCAAGAAACCAACTG	1	1.0	GCACATATATCTACTATTGGTGTTTGTT	{19899}
2.5126942636811997	20029	20117	88	20029	1	1.0	CCCGTAATGGTGTTCTTATTACAGAAGGTA	20087	1	1.0	TCCCAAACAAGCTAGTCTTAATGGAGTCAC	1	1.0	GTGTTAAAGGTTTACAACCATCTGTAGG	{20059}
2.5126942636811997	21846	21934	88	21846	1	1.0	CTGAGAAGTCTAACATAATAAGAGGCTGGA	21904	1	1.0	CCAGTCCCTACTTATTGTTAATAACGCTAC	1	1.0	TTTTTGGTACTACTTTAGATTCGAAGAC	{21876}
2.5126942636811997	22932	23020	88	22932	1	1.0	GGAAGTCTAATCTCAAACCTTTTGAGAGAG	22990	1	1.0	TAGCACACCTTGTAATGGTGTTGAAGGTTT	1	1.0	ATATTTCAACTGAAATCTATCAGGCCGG	{22962}
2.5126942636811997	23257	23345	88	23257	1	1.0	TGGCAGAGACATTGCTGACACTACTGATGC	23315	1	1.0	CTTGACATTACACCATGTTCTTTTGGTGGT	1	1.0	TGTCCGTGATCCACAGACACTTGAGATT	{23287}
2.5126942636811997	23381	23469	88	23381	1	1.0	CAGGTTGCTGTTCTTTATCAGGATGTTAAC	23439	1	1.0	CAGATCAACTTACTCCTACTTGGCGTGTTT	1	1.0	TGCACAGAAGTCCCTGTTGCTATTCATG	{23411}
2.5126942636811997	23589	23677	88	23589	1	1.0	CTCAGACTAATTCTCCTCGGCGGGCACGTA	23647	1	1.0	CACTATGTCACTTGGTGCAGAAAATTCAGT	1	1.0	GTGTAGCTAGTCAATCCATCATTGCCTA	{23619}
2.5126942636811997	24147	24235	88	24147	1	1.0	CACCTTTGCTCACAGATGAAATGATTGCTC	24205	1	1.0	AATCACTTCTGGTTGGACCTTTGGTGCAGG	1	1.0	AATACACTTCTGCACTGTTAGCGGGTAC	{24177}
2.5239433771173467	22348	22437	89	22348	1	1.0	TGCAGCTTATTATGTGGGTTATCTTCAACC	22407	1	1.0	ATGGAACCATTACAGATGCTGTAGACTGTG	1	1.0	TAGGACTTTTCTATTAAAATATAATGAA	{22378}
2.5239433771173467	22982	23071	89	22982	1	1.0	CAGGCCGGTAGCACACCTTGTAATGGTGTT	23041	1	1.0	ATCATATGGTTTCCAACCCACTAATGGTGT	1	1.0	GAAGGTTTTAATTGTTACTTTCCTTTAC	{23012}
2.534811090344213	15699	15789	90	15699	1	1.0	TCAATGATGATACTCTCTGACGATGCTGTT	15759	1	1.0	GGTCTAGTGGCTAGCATAAAGAACTTTAAG	1	1.0	GTGTGTTTCAATAGCACTTATGCATCTC	{15729}
2.565364373321448	6301	6394	93	6301	1	1.0	CTTTGGAGCACAAAACCAGTTGAAACATCA	6364	1	1.0	CAGGGAATGGATAATCTTGCCTGCGAAGAT	1	1.0	GTTTGATGTACTGAAGTCAGAGGACGCG	{6336}
2.5932573353204815	23192	23288	96	23192	1	1.0	AATGGTTTAACAGGCACAGGTGTTCTTACT	23258	1	1.0	GGCAGAGACATTGCTGACACTACTGATGCT	1	1.0	GAGTCTAACAAAAAGTTTCTGCCTTTCC	{23222}
2.6020405378427527	23449	23546	97	23449	1	1.0	TACTCCTACTTGGCGTGTTTATTCTACAGG	23516	1	1.0	GGGGCTGAACATGTCAACAACTCATATGAG	1	1.0	TTCTAATGTTTTTCAAACACGTGCAGGC	{23479}
2.6189163730311917	20306	20405	99	20306	1	1.0	CTATGCCTTCGAACATATCGTTTATGGAGA	20375	1	1.0	TGGACTAGCTAAACGTTTTAAGGAATCACC	1	1.0	GTCAGTTAGGTGGTTTACATCTACTGAT	{20347}
2.6426729313414405	14487	14589	102	14487	1	1.0	GAGCTAGGTGTTGTACATAATCAGGATGTA	14559	1	1.0	TATGCTGCTGACCCTGCTATGCACGCTGCT	1	1.0	TAGACTTAGTTTTAAGGAATTACTTGTG	{14531}
2.6426729313414405	25690	25792	102	25690	1	1.0	GGCCTTGAAGCCCCTTTTCTCTATCTTTAT	25762	1	1.0	ATAATGAGGCTTTGGCTTTGCTGGAAATGC	1	1.0	GCTTTAGTCTACTTCTTGCAGAGTATAA	{25720}
2.6575857056612073	12466	12570	104	12466	1	1.0	GCCAAACTAATGGTTGTCATACCAGACTAT	12540	1	1.0	ATCAGCATTGTGGGAAATCCAACAGGTTGT	1	1.0	CGTGTGATGGTACAACATTTACTTATGC	{12512}
2.6647897580044537	1900	2005	105	1900	1	1.0	TCAATTTTCTCCCGCACTCTTGAAACTGCT	1975	1	1.0	GATGGAATTTCACAGTATTCACTGAGACTC	1	1.0	CAAAATTCTGTGCGTGTTTTACAGAAGG	{1930}
2.6985648453679434	3131	3241	110	3131	1	1.0	AAGGTAAACCTTTGGAATTTGGTGCCACTT	3211	1	1.0	GATAGTCAACAAACTGTTGGTCAACAAGAC	1	1.0	CTGCTGCTCTTCAACCTGAAGAAGAGCA	{3161}
2.704912910986066	12024	12135	111	12024	1	1.0	CATGCAGGGTGCTGTAGACATAAACAAGCT	12105	1	1.0	GTTTAGTTCCCTTCCATCATATGCAGCTTT	1	1.0	TTGTGAAGAAATGCTGGACAACAGGGCA	{12054}
2.704912910986066	22225	22336	111	22225	1	1.0	GGCTTTAGAACCATTGGTAGATTTGCCAAT	22306	1	1.0	TTTGACTCCTGGTGATTCTTCTTCAGGTTG	1	1.0	GGTATTAACATCACTAGGTTTCAAACTT	{22256}
2.7348942636811997	22093	22209	116	22093	1	1.0	GGACCTTGAAGGAAAACAGGGTAATTTCAA	22179	1	1.0	AGCACACGCCTATTAATTTAGTGCGTGATC	1	1.0	ATTTGTGTTTAAGAATATTGATGGTTAT	{22135}
2.7405681611474058	21755	21872	117	21755	1	1.0	TTCCATGCTATACATGTCTCTGGGACCAAT	21842	1	1.0	TCCACTGAGAAGTCTAACATAATAAGAGGC	1	1.0	GGTACTAAGAGGTTTGATAACCCTGTCC	{21785}
2.751623285568201	80	199	119	80	1	1.0	AATCTGTGTGGCTGTCACTCGGCTGCATGC	169	1	1.0	ACTCGTCTATCTTCTGCAGGCTGCTTACGG	1	1.0	CAGTATAATTAATAACTAATTACTGTCG	{124}
2.751623285568201	2052	2171	119	2052	1	1.0	TGTAATGGCCTACATTACAGGTGGTGTTGT	2141	1	1.0	CCGTCCTTGATTGGCTTGAAGAGAAGTTTA	1	1.0	TCAGTTGACTTCGCAGTGGCTAACTAAC	{2082}
2.751623285568201	22348	22467	119	22348	1	1.0	TGCAGCTTATTATGTGGGTTATCTTCAACC	22437	1	1.0	CACTTGACCCTCTCTCAGAAACAAAGTGTA	1	1.0	TAGGACTTTTCTATTAAAATATAATGAA	{22378}
2.751623285568201	23589	23708	119	23589	1	1.0	CTCAGACTAATTCTCCTCGGCGGGCACGTA	23678	1	1.0	GCTTACTCTAATAACTCTATTGCCATACCC	1	1.0	GTGTAGCTAGTCAATCCATCATTGCCTA	{23619}
2.757011090344213	12796	12916	120	12796	1	1.0	GGTAGGTTTGTACTTGCACTGTTATCCGAT	12886	1	1.0	GAACTGGAACCACCTTGTAGGTTTGTTACA	1	1.0	TTACAGGATTTGAAATGGGCTAGATTCC	{12826}
2.757011090344213	22982	23102	120	22982	1	1.0	CAGGCCGGTAGCACACCTTGTAATGGTGTT	23072	1	1.0	GGTTACCAACCATACAGAGTAGTAGTACTT	1	1.0	GAAGGTTTTAATTGTTACTTTCCTTTAC	{23012}
2.7623098364064735	14165	14286	121	14165	1	1.0	GCCTATATTAACCTTGACCAGGGCTTTAAC	14256	1	1.0	TATGACTTCACGGAAGAGAGGTTAAAACTC	1	1.0	TGCAGAGTCACATGTTGACACTGACTTA	{14195}
2.7726515990016813	19893	20016	123	19893	1	1.0	GCTCCAGCACATATATCTACTATTGGTGTT	19986	1	1.0	TTTGATGGTAGAGTTGATGGTCAAGTAGAC	1	1.0	TAGACAAGAAACCAACTGAAACGATTTG	{19939}
2.792385018119717	6301	6428	127	6301	1	1.0	CTTTGGAGCACAAAACCAGTTGAAACATCA	6398	1	1.0	AACCAGTCTCTGAAGAAGTAGTGGAAAATC	1	1.0	GTTTGATGTACTGAAGTCAGAGGACGCG	{6336}
2.792385018119717	22687	22814	127	22687	1	1.0	CACTTTTAAGTGTTATGGAGTGTCTCCTAC	22784	1	1.0	AGACAAATCGCTCCAGGGCAAACTGGAAAG	1	1.0	TTCATTTGTAATTAGAGGTGATGAAGTC	{22756}
2.792385018119717	23449	23576	127	23449	1	1.0	TACTCCTACTTGGCGTGTTTATTCTACAGG	23546	1	1.0	TGTGACATACCCATTGGTGCAGGTATATGC	1	1.0	TTCTAATGTTTTTCAAACACGTGCAGGC	{23479}
2.8064266863651715	20350	20480	130	20350	1	1.0	AGTTAGGTGGTTTACATCTACTGATTGGAC	20450	1	1.0	CTATTTCATAACAGATGCGCAAACAGGTTC	1	1.0	TAGCTAAACGTTTTAAGGAATCACCTTT	{20380}
2.8109738099539405	23749	23880	131	23749	1	1.0	GTCTATGACCAAGACATCAGTAGATTGTAC	23850	1	1.0	TAAACCGTGCTTTAACTGGAATAGCTGTTG	1	1.0	TCAACTGAATGCAGCAATCTTTTGTTGC	{23798}
2.8154573353204815	21904	22036	132	21904	1	1.0	CCAGTCCCTACTTATTGTTAATAACGCTAC	22006	1	1.0	CAACAAAAGTTGGATGGAAAGTGAGTTCAG	1	1.0	TAATGTTGTTATTAAAGTCTGTGAATTT	{21934}
2.8154573353204815	22582	22714	132	22582	1	1.0	AGTTTTTAACGCCACCAGATTTGCATCTGT	22684	1	1.0	TTCCACTTTTAAGTGTTATGGAGTGTCTCC	1	1.0	TTATGCTTGGAACAGGAAGAGAATCAGC	{22612}
2.8154573353204815	25690	25822	132	25690	1	1.0	GGCCTTGAAGCCCCTTTTCTCTATCTTTAT	25792	1	1.0	CGTTCCAAAAACCCATTACTTTATGATGCC	1	1.0	GCTTTAGTCTACTTCTTGCAGAGTATAA	{25720}
2.8285435130281846	20897	21032	135	20897	1	1.0	AGGTACAGCTGTTTTAAGACAGTGGTTGCC	21002	1	1.0	GTGCAACTGTACATACAGCTAATAAATGGG	1	1.0	TACGGGTACGCTGCTTGTCGATTCAGAT	{20927}
2.8285435130281846	22854	22989	135	22854	1	1.0	GCTGCGTTATAGCTTGGAATTCTAACAATC	22959	1	1.0	GAGATATTTCAACTGAAATCTATCAGGCCG	1	1.0	GATTCTAAGGTTGGTGGTAATTATAATT	{22886}
2.8327894934871645	3176	3312	136	3176	1	1.0	CTGAAGAAGAGCAAGAAGAAGATTGGTTAG	3282	1	1.0	TGAGGTTCAACCTCAATTAGAGATGGAACT	1	1.0	TGATGATAGTCAACAAACTGTTGGTCAA	{3207}
2.836979969342407	3875	4012	137	3875	1	1.0	CTGAGATTCCTAAAGAGGAAGTTAAGCCAT	3982	1	1.0	ACAACAACTCTGGAAGAAACTAAGTTCCTC	1	1.0	CAAGATGATAAGAAAATCAAAGCTTGTG	{3943}
2.8411163730311917	15651	15789	138	15651	1	1.0	GACACAGACTTTGTGAATGAGTTTTACGCA	15759	1	1.0	GGTCTAGTGGCTAGCATAAAGAACTTTAAG	1	1.0	GTGTGTTTCAATAGCACTTATGCATCTC	{15729}
2.8532146706409636	12024	12165	141	12024	1	1.0	CATGCAGGGTGCTGTAGACATAAACAAGCT	12135	1	1.0	TGCTACTGCTCAAGAAGCTTATGAGCAGGC	1	1.0	TTGTGAAGAAATGCTGGACAACAGGGCA	{12054}
2.8532146706409636	22225	22366	141	22225	1	1.0	GGCTTTAGAACCATTGGTAGATTTGCCAAT	22336	1	1.0	GACAGCTGGTGCTGCAGCTTATTATGTGGG	1	1.0	GGTATTAACATCACTAGGTTTCAAACTT	{22256}
2.8571480554261384	8524	8666	142	8524	1	1.0	GTAACAACAAAGATAGCACTTAAGGGTGGT	8636	1	1.0	CACCTGTTCATGTCATGTCTAAACATACTG	1	1.0	GTTCCTTTTTGTTGCTGCTATTTTCTAT	{8601}
2.8610337616452868	16206	16349	143	16206	1	1.0	GCTATGTACACACCGCATACAGTCTTACAG	16319	1	1.0	ATGCTGTTACGACCATGTCATATCAACATC	1	1.0	GCTGTTGGGGCTTGTGTTCTTTGCAATT	{16236}
2.8610337616452868	29224	29367	143	29224	1	1.0	GTCGCGCATTGGCATGGAAGTCACACCTTC	29337	1	1.0	AGCATATTGACGCATACAAAACATTCCCAC	1	1.0	GGGAACGTGGTTGACCTACACAGGTGCC	{29254}
2.8724160284948064	22093	22239	146	22093	1	1.0	GGACCTTGAAGGAAAACAGGGTAATTTCAA	22209	1	1.0	TCCCTCAGGGTTTTTCGGCTTTAGAACCAT	1	1.0	ATTTGTGTTTAAGAATATTGATGGTTAT	{22135}
2.876122044777587	20169	20316	147	20169	1	1.0	GGTGTTGTCCAACAATTACCTGAAACTTAC	20286	1	1.0	GAACGGTATAAATTAGAAGGCTATGCCTTC	1	1.0	GAAATTTACAAGAATTTAAACCCAGGAG	{20212}
2.8797857056612073	19472	19620	148	19472	1	1.0	TTTAGGTGGTGCTGTCTGTAGACATCATGC	19590	1	1.0	AACCTCTGGAACACTTTTACAAGACTTCAG	1	1.0	TAATGAGTACAGATTGTATCTCGATGCT	{19502}
2.8797857056612073	23257	23405	148	23257	1	1.0	TGGCAGAGACATTGCTGACACTACTGATGC	23375	1	1.0	TCTAACCAGGTTGCTGTTCTTTATCAGGAT	1	1.0	TGTCCGTGATCCACAGACACTTGAGATT	{23287}
2.8834079683607334	80	229	149	80	1	1.0	AATCTGTGTGGCTGTCACTCGGCTGCATGC	199	1	1.0	TTTCGTCCGTGTTGCAGCCGATCATCAGCA	1	1.0	CAGTATAATTAATAACTAATTACTGTCG	{124}
2.8834079683607334	2052	2201	149	2052	1	1.0	TGTAATGGCCTACATTACAGGTGGTGTTGT	2171	1	1.0	AGGAAGGTGTAGAGTTTCTTAGAGACGGTT	1	1.0	TCAGTTGACTTCGCAGTGGCTAACTAAC	{2082}
2.8834079683607334	15699	15848	149	15699	1	1.0	TCAATGATGATACTCTCTGACGATGCTGTT	15818	1	1.0	TATGTCTGAAGCAAAATGTTGGACTGAGAC	1	1.0	GTGTGTTTCAATAGCACTTATGCATCTC	{15729}
2.8869897580044537	12796	12946	150	12796	1	1.0	GGTAGGTTTGTACTTGCACTGTTATCCGAT	12916	1	1.0	GACACACCTAAAGGTCCTAAAGTGAAGTAT	1	1.0	TTACAGGATTTGAAATGGGCTAGATTCC	{12826}
2.8869897580044537	22982	23132	150	22982	1	1.0	CAGGCCGGTAGCACACCTTGTAATGGTGTT	23102	1	1.0	TCTTTTGAACTTCTACATGCACCAGCAACT	1	1.0	GAAGGTTTTAATTGTTACTTTCCTTTAC	{23012}
2.8940354666358683	24168	24320	152	24168	1	1.0	TGATTGCTCAATACACTTCTGCACTGTTAG	24290	1	1.0	GGAGTTACACAGAATGTTCTCTATGAGAAC	1	1.0	CGGGTACAATCACTTCTGGTTGGACCTT	{24198}
2.907678667660241	19801	19957	156	19801	1	1.0	GCAACATTAAACCAGTACCAGAGGTGAAAA	19927	1	1.0	CTATGACTGACATAGCCAAGAAACCAACTG	1	1.0	GCACATATATCTACTATTGGTGTTTGTT	{19899}
2.907678667660241	19953	20109	156	19953	1	1.0	ACTGAAACGATTTGTGCACCACTCACTGTC	20079	1	1.0	TCTGTAGGTCCCAAACAAGCTAGTCTTAAT	1	1.0	AGAAGGTAGTGTTAAAGGTTTACAACCA	{20051}
2.91100063353398	6301	6458	157	6301	1	1.0	CTTTGGAGCACAAAACCAGTTGAAACATCA	6428	1	1.0	CTACCATACAGAAAGACGTTCTTGAGTGTA	1	1.0	GTTTGATGTACTGAAGTCAGAGGACGCG	{6336}
2.917543040981689	20030	20189	159	20030	1	1.0	CCGTAATGGTGTTCTTATTACAGAAGGTAG	20159	1	1.0	GAAAGTTGATGGTGTTGTCCAACAATTACC	1	1.0	TGTTAAAGGTTTACAACCATCTGTAGGT	{20060}
2.920764845367944	19893	20053	160	19893	1	1.0	GCTCCAGCACATATATCTACTATTGGTGTT	20023	1	1.0	GAAATGCCCGTAATGGTGTTCTTATTACAG	1	1.0	TAGACAAGAAACCAACTGAAACGATTTG	{19939}
2.927112910986066	22458	22620	162	22458	1	1.0	CAAAGTGTACGTTGAAATCCTTCACTGTAG	22590	1	1.0	ACGCCACCAGATTTGCATCTGTTTATGCTT	1	1.0	AGTCCAACCAACAGAATCTATTGTTAGA	{22519}
2.927112910986066	23126	23288	162	23126	1	1.0	GCAACTGTTTGTGGACCTAAAAAGTCTACT	23258	1	1.0	GGCAGAGACATTGCTGACACTACTGATGCT	1	1.0	CTTACTGAGTCTAACAAAAAGTTTCTGC	{23216}
2.930240417140111	1900	2063	163	1900	1	1.0	TCAATTTTCTCCCGCACTCTTGAAACTGCT	2033	1	1.0	TGGCTACTAACAATCTAGTTGTAATGGCCT	1	1.0	CAAAATTCTGTGCGTGTTTTACAGAAGG	{1930}
2.930240417140111	23589	23752	163	23589	1	1.0	CTCAGACTAATTCTCCTCGGCGGGCACGTA	23722	1	1.0	TAGTGTTACCACAGAAATTCTACCAGTGTC	1	1.0	GTGTAGCTAGTCAATCCATCATTGCCTA	{23619}
2.9364053540254123	14121	14286	165	14121	1	1.0	GGTAGTGGAGTTCCTGTTGTAGATTCTTAT	14256	1	1.0	TATGACTTCACGGAAGAGAGGTTAAAACTC	1	1.0	TGCAGAGTCACATGTTGACACTGACTTA	{14195}
2.9364053540254123	19395	19560	165	19395	1	1.0	GAGTCTCATGGAAAACAAGTAGTGTCAGAT	19530	1	1.0	TATAACATGATGATCTCAGCTGGCTTTAGC	1	1.0	GCTAATGAGTACAGATTGTATCTCGATG	{19500}
2.9364053540254123	22797	22962	165	22797	1	1.0	CAGGGCAAACTGGAAAGATTGCTGATTATA	22932	1	1.0	GGAAGTCTAATCTCAAACCTTTTGAGAGAG	1	1.0	CTAACAATCTTGATTCTAAGGTTGGTGG	{22875}
2.9364053540254123	22854	23019	165	22854	1	1.0	GCTGCGTTATAGCTTGGAATTCTAACAATC	22989	1	1.0	GTAGCACACCTTGTAATGGTGTTGAAGGTT	1	1.0	GATTCTAAGGTTGGTGGTAATTATAATT	{22886}
2.9364053540254123	25621	25786	165	25621	1	1.0	GTTCACTTTGTTTGCAACTTGCTGTTGTTG	25756	1	1.0	AGAATAATAATGAGGCTTTGGCTTTGCTGG	1	1.0	TTTATGCTTTAGTCTACTTCTTGCAGAG	{25715}
2.939443925003943	14487	14653	166	14487	1	1.0	GAGCTAGGTGTTGTACATAATCAGGATGTA	14623	1	1.0	GCTTTTCAGTAGCTGCACTTACTAACAATG	1	1.0	TAGACTTAGTTTTAAGGAATTACTTGTG	{14531}
2.9424539643783345	3306	3473	167	3306	1	1.0	GGAACTTACACCAGTTGTTCAGACTATTGA	3443	1	1.0	CAGCCAATGTTTACCTTAAACATGGAGGAG	1	1.0	AGTGAATAGTTTTAGTGGTTATTTAAAA	{3336}
2.9570942636811997	12466	12638	172	12466	1	1.0	GCCAAACTAATGGTTGTCATACCAGACTAT	12608	1	1.0	GTATGGACAATTCACCTAATTTAGCATGGC	1	1.0	CGTGTGATGGTACAACATTTACTTATGC	{12512}
2.9599437654486547	23749	23922	173	23749	1	1.0	GTCTATGACCAAGACATCAGTAGATTGTAC	23892	1	1.0	ACACCCAAGAAGTTTTTGCACAAGTCAAAC	1	1.0	TCAACTGAATGCAGCAATCTTTTGTTGC	{23798}
2.9683433771173466	22638	22814	176	22638	1	1.0	GCAACTGTGTTGCTGATTATTCTGTCCTAT	22784	1	1.0	AGACAAATCGCTCCAGGGCAAACTGGAAAG	1	1.0	TTCATTTGTAATTAGAGGTGATGAAGTC	{22756}
2.9710950406914325	14165	14342	177	14165	1	1.0	GCCTATATTAACCTTGACCAGGGCTTTAAC	14312	1	1.0	TCAGACATACCACCCAAATTGTGTTAACTG	1	1.0	TGCAGAGTCACATGTTGACACTGACTTA	{14195}
2.973823285568201	16116	16294	178	16116	1	1.0	GATGAGTTAACAGGACACATGTTAGACATG	16264	1	1.0	CACAGACTTCATTAAGATGTGGTGCTTGCA	1	1.0	GCTGTTGGGGCTTGTGTTCTTTGCAATT	{16236}
2.9765285070070253	80	259	179	80	1	1.0	AATCTGTGTGGCTGTCACTCGGCTGCATGC	229	1	1.0	CATCTAGGTTTCGTCCGGGTGTGACCGAAA	1	1.0	CAGTATAATTAATAACTAATTACTGTCG	{124}
2.9765285070070253	8487	8666	179	8487	1	1.0	GTTGACATGTGCAACTACTAGACAAGTTGT	8636	1	1.0	CACCTGTTCATGTCATGTCTAAACATACTG	1	1.0	GTTCCTTTTTGTTGCTGCTATTTTCTAT	{8601}
2.9765285070070253	22687	22866	179	22687	1	1.0	CACTTTTAAGTGTTATGGAGTGTCTCCTAC	22836	1	1.0	TACCAGATGATTTTACAGGCTGCGTTATAG	1	1.0	TTCATTTGTAATTAGAGGTGATGAAGTC	{22756}
2.979211090344213	15699	15879	180	15699	1	1.0	TCAATGATGATACTCTCTGACGATGCTGTT	15849	1	1.0	GACCTTACTAAAGGACCTCATGAATTTTGC	1	1.0	GTGTGTTTCAATAGCACTTATGCATCTC	{15729}
2.9845098364064735	23678	23860	182	23678	1	1.0	GCTTACTCTAATAACTCTATTGCCATACCC	23830	1	1.0	TGGCAGTTTTTGTACACAATTAAACCGTGC	1	1.0	TCAACTGAATGCAGCAATCTTTTGTTGC	{23798}
2.992297268051916	21904	22089	185	21904	1	1.0	CCAGTCCCTACTTATTGTTAATAACGCTAC	22059	1	1.0	GCACTTTTGAATATGTCTCTCAGCCTTTTC	1	1.0	TAATGTTGTTATTAAAGTCTGTGAATTT	{21934}
2.9948515990016813	8524	8710	186	8524	1	1.0	GTAACAACAAAGATAGCACTTAAGGGTGGT	8680	1	1.0	ATCATAGGATACAAGGCTATTGATGGTGGT	1	1.0	GTTCCTTTTTGTTGCTGCTATTTTCTAT	{8601}
2.9948515990016813	19953	20139	186	19953	1	1.0	ACTGAAACGATTTGTGCACCACTCACTGTC	20109	1	1.0	GGAGTCACATTAATTGGAGAAGCCGTAAAA	1	1.0	AGAAGGTAGTGTTAAAGGTTTACAACCA	{20051}
2.9948515990016813	22022	22208	186	22022	1	1.0	GAAAGTGAGTTCAGAGTTTATTCTAGTGCG	22178	1	1.0	AAGCACACGCCTATTAATTTAGTGCGTGAT	1	1.0	CTCAGCCTTTTCTTATGGACCTTGAAGG	{22077}
2.997385737400775	6301	6488	187	6301	1	1.0	CTTTGGAGCACAAAACCAGTTGAAACATCA	6458	1	1.0	ATGTGAAAACTACCGAAGTTGTAGGAGACA	1	1.0	GTTTGATGTACTGAAGTCAGAGGACGCG	{6336}
2.9999	29224	29412	188	29224	1	1.0	GTCGCGCATTGGCATGGAAGTCACACCTTC	29382	1	1.0	AGGACAAAAAGAAGAAGGCTGATGAAACTC	1	1.0	GGGAACGTGGTTGACCTACACAGGTGCC	{29254}
3.0048701280549226	15599	15789	190	15599	1	1.0	CCGCAATTTACAACACAGACTTTATGAGTG	15759	1	1.0	GGTCTAGTGGCTAGCATAAAGAACTTTAAG	1	1.0	GTGTGTTTCAATAGCACTTATGCATCTC	{15729}
3.0048701280549226	16206	16396	190	16206	1	1.0	GCTATGTACACACCGCATACAGTCTTACAG	16366	1	1.0	CTGTTAATCCGTATGTTTGCAATGCTCCAG	1	1.0	GCTGTTGGGGCTTGTGTTCTTTGCAATT	{16236}
3.0073265909416214	20169	20360	191	20169	1	1.0	GGTGTTGTCCAACAATTACCTGAAACTTAC	20330	1	1.0	TGGAGATTTTAGTCATAGTCAGTTAGGTGG	1	1.0	GAAATTTACAAGAATTTAAACCCAGGAG	{20212}
3.0097643733214485	22458	22650	192	22458	1	1.0	CAAAGTGTACGTTGAAATCCTTCACTGTAG	22620	1	1.0	GGAACAGGAAGAGAATCAGCAACTGTGTTG	1	1.0	AGTCCAACCAACAGAATCTATTGTTAGA	{22519}
3.0097643733214485	23126	23318	192	23126	1	1.0	GCAACTGTTTGTGGACCTAAAAAGTCTACT	23288	1	1.0	GTCCGTGATCCACAGACACTTGAGATTCTT	1	1.0	CTTACTGAGTCTAACAAAAAGTTTCTGC	{23216}
3.0121837571683643	1900	2093	193	1900	1	1.0	TCAATTTTCTCCCGCACTCTTGAAACTGCT	2063	1	1.0	ACATTACAGGTGGTGTTGTTCAGTTGACTT	1	1.0	CAAAATTCTGTGCGTGTTTTACAGAAGG	{1930}
3.0121837571683643	3875	4068	193	3875	1	1.0	CTGAGATTCCTAAAGAGGAAGTTAAGCCAT	4038	1	1.0	CATTAATGGCAATCTTCATCCAGATTCTGC	1	1.0	CAAGATGATAAGAAAATCAAAGCTTGTG	{3943}
3.0193342433258255	22797	22993	196	22797	1	1.0	CAGGGCAAACTGGAAAGATTGCTGATTATA	22963	1	1.0	TATTTCAACTGAAATCTATCAGGCCGGTAG	1	1.0	CTAACAATCTTGATTCTAAGGTTGGTGG	{22875}
3.026328706359163	25621	25820	199	25621	1	1.0	GTTCACTTTGTTTGCAACTTGCTGTTGTTG	25790	1	1.0	GCCGTTCCAAAAACCCATTACTTTATGATG	1	1.0	TTTATGCTTTAGTCTACTTCTTGCAGAG	{25715}
3.0286266863651714	11938	12138	200	11938	1	1.0	GTCCAGTTACACAATGACATTCTCTTAGCT	12108	1	1.0	TAGTTCCCTTCCATCATATGCAGCTTTTGC	1	1.0	TTGTGAAGAAATGCTGGACAACAGGGCA	{12054}
3.030908310503012	14406	14607	201	14406	1	1.0	CCTACAAGTTTTGGACCACTAGTGAGAAAA	14577	1	1.0	ATGCACGCTGCTTCTGGTAATCTATTACTA	1	1.0	TAGACTTAGTTTTAAGGAATTACTTGTG	{14531}
3.0331738099539405	21423	21625	202	21423	1	1.0	GGGTACTGCTGTTATGTCTTTAAAAGAAGG	21595	1	1.0	CTCTAGTCAGTGTGTTAATCTTACAACCAG	1	1.0	CAACTAAACGAACAATGTTTGTTTTTCT	{21549}
3.0376573353204814	3216	3420	204	3216	1	1.0	TCAACAAACTGTTGGTCAACAAGACGGCAG	3390	1	1.0	TGCAGACATTGTGGAAGAAGCTAAAAAGGT	1	1.0	AATTAGAGATGGAACTTACACCAGTTGT	{3296}
3.0398757998013184	19472	19677	205	19472	1	1.0	TTTAGGTGGTGCTGTCTGTAGACATCATGC	19647	1	1.0	GTAAATAAGGGACACTTTGATGGACAACAG	1	1.0	TAATGAGTACAGATTGTATCTCGATGCT	{19502}
3.0398757998013184	19593	19798	205	19593	1	1.0	CTCTGGAACACTTTTACAAGACTTCAGAGT	19768	1	1.0	CTGTTAATGTAGCATTTGAGCTTTGGGCTA	1	1.0	TGATGGACAACAGGGTGAAGTACCAGTT	{19664}
3.04207901698314	15651	15857	206	15651	1	1.0	GACACAGACTTTGTGAATGAGTTTTACGCA	15827	1	1.0	AGCAAAATGTTGGACTGAGACTGACCTTAC	1	1.0	GTGTGTTTCAATAGCACTTATGCATCTC	{15729}
3.04426719502264	14165	14372	207	14165	1	1.0	GCCTATATTAACCTTGACCAGGGCTTTAAC	14342	1	1.0	TTTGGATGACAGATGCATTCTGCATTGTGC	1	1.0	TGCAGAGTCACATGTTGACACTGACTTA	{14195}
3.04426719502264	20109	20316	207	20109	1	1.0	GGAGTCACATTAATTGGAGAAGCCGTAAAA	20286	1	1.0	GAACGGTATAAATTAGAAGGCTATGCCTTC	1	1.0	GAAATTTACAAGAATTTAAACCCAGGAG	{20212}
3.0464405378427526	22854	23062	208	22854	1	1.0	GCTGCGTTATAGCTTGGAATTCTAACAATC	23032	1	1.0	TCCTTTACAATCATATGGTTTCCAACCCAC	1	1.0	GATTCTAAGGTTGGTGGTAATTATAATT	{22886}
3.048599245246692	80	289	209	80	1	1.0	AATCTGTGTGGCTGTCACTCGGCTGCATGC	259	1	1.0	GGTAAGATGGAGAGCCTTGTCCCTGGTTTC	1	1.0	CAGTATAATTAATAACTAATTACTGTCG	{124}
3.0528735330780323	2052	2263	211	2052	1	1.0	TGTAATGGCCTACATTACAGGTGGTGTTGT	2233	1	1.0	TGTGAAATTGTCGGTGGACAAATTGTCACC	1	1.0	TCAGTTGACTTCGCAGTGGCTAACTAAC	{2082}
3.0528735330780323	15699	15910	211	15699	1	1.0	TCAATGATGATACTCTCTGACGATGCTGTT	15880	1	1.0	CTCAACATACAATGCTAGTTAAACAGGGTG	1	1.0	GTGTGTTTCAATAGCACTTATGCATCTC	{15729}
3.0612548428519353	12466	12681	215	12466	1	1.0	GCCAAACTAATGGTTGTCATACCAGACTAT	12651	1	1.0	AGCTTTAAGGGCCAATTCTGCTGTCAAATT	1	1.0	CGTGTGATGGTACAACATTTACTTATGC	{12512}
3.0612548428519353	19801	20016	215	19801	1	1.0	GCAACATTAAACCAGTACCAGAGGTGAAAA	19986	1	1.0	TTTGATGGTAGAGTTGATGGTCAAGTAGAC	1	1.0	GCACATATATCTACTATTGGTGTTTGTT	{19899}
3.0633163730311916	8524	8740	216	8524	1	1.0	GTAACAACAAAGATAGCACTTAAGGGTGGT	8710	1	1.0	GTCACTCGTGACATAGCATCTACAGATACT	1	1.0	GTTCCTTTTTGTTGCTGCTATTTTCTAT	{8601}
3.0633163730311916	22022	22238	216	22022	1	1.0	GAAAGTGAGTTCAGAGTTTATTCTAGTGCG	22208	1	1.0	CTCCCTCAGGGTTTTTCGGCTTTAGAACCA	1	1.0	CTCAGCCTTTTCTTATGGACCTTGAAGG	{22077}
3.0633163730311916	22225	22441	216	22225	1	1.0	GGCTTTAGAACCATTGGTAGATTTGCCAAT	22411	1	1.0	AACCATTACAGATGCTGTAGACTGTGCACT	1	1.0	GGTATTAACATCACTAGGTTTCAAACTT	{22256}
3.0653647304037195	6186	6403	217	6186	1	1.0	CTACACACCCTCTTTTAAGAAAGGAGCTAA	6373	1	1.0	GATAATCTTGCCTGCGAAGATCTAAAACCA	1	1.0	GTTTGATGTACTGAAGTCAGAGGACGCG	{6336}
3.0653647304037195	21904	22121	217	21904	1	1.0	CCAGTCCCTACTTATTGTTAATAACGCTAC	22091	1	1.0	ATGGACCTTGAAGGAAAACAGGGTAATTTC	1	1.0	TAATGTTGTTATTAAAGTCTGTGAATTT	{21934}
3.0653647304037195	24168	24385	217	24168	1	1.0	TGATTGCTCAATACACTTCTGCACTGTTAG	24355	1	1.0	TGGCAAAATTCAAGACTCACTTTCTTCCAC	1	1.0	CGGGTACAATCACTTCTGGTTGGACCTT	{24198}
3.0674000822449523	29224	29442	218	29224	1	1.0	GTCGCGCATTGGCATGGAAGTCACACCTTC	29412	1	1.0	AAGCCTTACCGCAGAGACAGAAGAAACAGC	1	1.0	GGGAACGTGGTTGACCTACACAGGTGCC	{29254}
3.069422592664184	3306	3525	219	3306	1	1.0	GGAACTTACACCAGTTGTTCAGACTATTGA	3495	1	1.0	GGCTACTAACAATGCCATGCAAGTTGAATC	1	1.0	AGTGAATAGTTTTAGTGGTTATTTAAAA	{3336}
3.069422592664184	12796	13015	219	12796	1	1.0	GGTAGGTTTGTACTTGCACTGTTATCCGAT	12985	1	1.0	ATGGTACTTGGTAGTTTAGCTGCCACAGTA	1	1.0	TTACAGGATTTGAAATGGGCTAGATTCC	{12826}
3.069422592664184	23678	23897	219	23678	1	1.0	GCTTACTCTAATAACTCTATTGCCATACCC	23867	1	1.0	GGAATAGCTGTTGAACAAGACAAAAACACC	1	1.0	TCAACTGAATGCAGCAATCTTTTGTTGC	{23798}
3.071432422683972	16206	16426	220	16206	1	1.0	GCTATGTACACACCGCATACAGTCTTACAG	16396	1	1.0	GTTGTGATGTCACAGATGTGACTCAACTTT	1	1.0	GCTGTTGGGGCTTGTGTTCTTTGCAATT	{16236}
3.0734297303170677	12024	12245	221	12024	1	1.0	CATGCAGGGTGCTGTAGACATAAACAAGCT	12215	1	1.0	TGAATGTGGCTAAATCTGAATTTGACCGTG	1	1.0	TTGTGAAGAAATGCTGGACAACAGGGCA	{12054}
3.0734297303170677	14121	14342	221	14121	1	1.0	GGTAGTGGAGTTCCTGTTGTAGATTCTTAT	14312	1	1.0	TCAGACATACCACCCAAATTGTGTTAACTG	1	1.0	TGCAGAGTCACATGTTGACACTGACTTA	{14195}
3.0754146706409635	8487	8709	222	8487	1	1.0	GTTGACATGTGCAACTACTAGACAAGTTGT	8679	1	1.0	AATCATAGGATACAAGGCTATTGATGGTGG	1	1.0	GTTCCTTTTTGTTGCTGCTATTTTCTAT	{8601}
3.0754146706409635	23126	23348	222	23126	1	1.0	GCAACTGTTTGTGGACCTAAAAAGTCTACT	23318	1	1.0	GACATTACACCATGTTCTTTTGGTGGTGTC	1	1.0	CTTACTGAGTCTAACAAAAAGTTTCTGC	{23216}
3.077387395870145	23589	23812	223	23589	1	1.0	CTCAGACTAATTCTCCTCGGCGGGCACGTA	23782	1	1.0	GTACATTTGTGGTGATTCAACTGAATGCAG	1	1.0	GTGTAGCTAGTCAATCCATCATTGCCTA	{23619}
3.0793480554261383	12346	12570	224	12346	1	1.0	GCTATGCAGACAATGCTTTTCACTATGCTT	12540	1	1.0	ATCAGCATTGTGGGAAATCCAACAGGTTGT	1	1.0	CGTGTGATGGTACAACATTTACTTATGC	{12512}
3.0812967960054203	19395	19620	225	19395	1	1.0	GAGTCTCATGGAAAACAAGTAGTGTCAGAT	19590	1	1.0	AACCTCTGGAACACTTTTACAAGACTTCAG	1	1.0	GCTAATGAGTACAGATTGTATCTCGATG	{19500}
3.0812967960054203	25690	25915	225	25690	1	1.0	GGCCTTGAAGCCCCTTTTCTCTATCTTTAT	25885	1	1.0	TCTTCAATTGTCATTACTTCAGGTGATGGC	1	1.0	GCTTTAGTCTACTTCTTGCAGAGTATAA	{25720}
3.087072931341441	22638	22866	228	22638	1	1.0	GCAACTGTGTTGCTGATTATTCTGTCCTAT	22836	1	1.0	TACCAGATGATTTTACAGGCTGCGTTATAG	1	1.0	TTCATTTGTAATTAGAGGTGATGAAGTC	{22756}
3.090866666009797	11938	12168	230	11938	1	1.0	GTCCAGTTACACAATGACATTCTCTTAGCT	12138	1	1.0	TACTGCTCAAGAAGCTTATGAGCAGGCTGT	1	1.0	TTGTGAAGAAATGCTGGACAACAGGGCA	{12054}
3.090866666009797	22982	23212	230	22982	1	1.0	CAGGCCGGTAGCACACCTTGTAATGGTGTT	23182	1	1.0	TTTCAACTTCAATGGTTTAACAGGCACAGG	1	1.0	GAAGGTTTTAATTGTTACTTTCCTTTAC	{23012}
3.0927468288076465	14406	14637	231	14406	1	1.0	CCTACAAGTTTTGGACCACTAGTGAGAAAA	14607	1	1.0	GATAAACGCACTACGTGCTTTTCAGTAGCT	1	1.0	TAGACTTAGTTTTAAGGAATTACTTGTG	{14531}
3.0946160284948063	8434	8666	232	8434	1	1.0	CAACTACGAAAACAAATACGTAGTGCTGCT	8636	1	1.0	CACCTGTTCATGTCATGTCTAAACATACTG	1	1.0	GTTCCTTTTTGTTGCTGCTATTTTCTAT	{8601}
3.0946160284948063	14487	14719	232	14487	1	1.0	GAGCTAGGTGTTGTACATAATCAGGATGTA	14689	1	1.0	AAGACTTCTATGACTTTGCTGTGTCTAAGG	1	1.0	TAGACTTAGTTTTAAGGAATTACTTGTG	{14531}
3.0946160284948063	16062	16294	232	16062	1	1.0	CAGGAGTATGCTGATGTCTTTCATTTGTAC	16264	1	1.0	CACAGACTTCATTAAGATGTGGTGCTTGCA	1	1.0	GCTGTTGGGGCTTGTGTTCTTTGCAATT	{16236}
3.0946160284948063	21423	21655	232	21423	1	1.0	GGGTACTGCTGTTATGTCTTTAAAAGAAGG	21625	1	1.0	AACTCAATTACCCCCTGCATACACTAATTC	1	1.0	CAACTAAACGAACAATGTTTGTTTTTCT	{21549}
3.0946160284948063	22361	22593	232	22361	1	1.0	GTGGGTTATCTTCAACCTAGGACTTTTCTA	22563	1	1.0	ACTTGTGCCCTTTTGGTGAAGTTTTTAACG	1	1.0	GTTGAAATCCTTCACTGTAGAAAAAGGA	{22468}
3.09647439218088	16116	16349	233	16116	1	1.0	GATGAGTTAACAGGACACATGTTAGACATG	16319	1	1.0	ATGCTGTTACGACCATGTCATATCAACATC	1	1.0	GCTGTTGGGGCTTGTGTTCTTTGCAATT	{16236}
3.098322044777587	3216	3450	234	3216	1	1.0	TCAACAAACTGTTGGTCAACAAGACGGCAG	3420	1	1.0	AAAACCAACAGTGGTTGTTAATGCAGCCAA	1	1.0	AATTAGAGATGGAACTTACACCAGTTGT	{3296}
3.100159109049143	19593	19828	235	19593	1	1.0	CTCTGGAACACTTTTACAAGACTTCAGAGT	19798	1	1.0	AGCGCAACATTAAACCAGTACCAGAGGTGA	1	1.0	TGATGGACAACAGGGTGAAGTACCAGTT	{19664}
3.1019857056612072	19953	20189	236	19953	1	1.0	ACTGAAACGATTTGTGCACCACTCACTGTC	20159	1	1.0	GAAAGTTGATGGTGTTGTCCAACAATTACC	1	1.0	AGAAGGTAGTGTTAAAGGTTTACAACCA	{20051}
3.1019857056612072	20169	20405	236	20169	1	1.0	GGTGTTGTCCAACAATTACCTGAAACTTAC	20375	1	1.0	TGGACTAGCTAAACGTTTTAAGGAATCACC	1	1.0	GAAATTTACAAGAATTTAAACCCAGGAG	{20212}
3.1056079683607334	22854	23092	238	22854	1	1.0	GCTGCGTTATAGCTTGGAATTCTAACAATC	23062	1	1.0	TAATGGTGTTGGTTACCAACCATACAGAGT	1	1.0	GATTCTAAGGTTGGTGGTAATTATAATT	{22886}
3.1074038657081178	80	319	239	80	1	1.0	AATCTGTGTGGCTGTCACTCGGCTGCATGC	289	1	1.0	AACGAGAAAACACACGTCCAACTCAGTTTG	1	1.0	CAGTATAATTAATAACTAATTACTGTCG	{124}
3.1074038657081178	15651	15890	239	15651	1	1.0	GACACAGACTTTGTGAATGAGTTTTACGCA	15860	1	1.0	AGGACCTCATGAATTTTGCTCTCAACATAC	1	1.0	GTGTGTTTCAATAGCACTTATGCATCTC	{15729}
3.1074038657081178	22093	22332	239	22093	1	1.0	GGACCTTGAAGGAAAACAGGGTAATTTCAA	22302	1	1.0	GTTATTTGACTCCTGGTGATTCTTCTTCAG	1	1.0	ATTTGTGTTTAAGAATATTGATGGTTAT	{22135}
3.1091897580044536	3772	4012	240	3772	1	1.0	CGCACAAATGTCTACTTAGCTGTCTTTGAT	3982	1	1.0	ACAACAACTCTGGAAGAAACTAAGTTCCTC	1	1.0	CAAGATGATAAGAAAATCAAAGCTTGTG	{3943}
3.1091897580044536	14349	14589	240	14349	1	1.0	GACAGATGCATTCTGCATTGTGCAAACTTT	14559	1	1.0	TATGCTGCTGACCCTGCTATGCACGCTGCT	1	1.0	TAGACTTAGTTTTAAGGAATTACTTGTG	{14531}
3.1109657561098882	2052	2293	241	2052	1	1.0	TGTAATGGCCTACATTACAGGTGGTGTTGT	2263	1	1.0	TGTGCAAAGGAAATTAAGGAGAGTGTTCAG	1	1.0	TCAGTTGACTTCGCAGTGGCTAACTAAC	{2082}
3.1109657561098882	15699	15940	241	15699	1	1.0	TCAATGATGATACTCTCTGACGATGCTGTT	15910	1	1.0	ATGATTATGTGTACCTTCCTTACCCAGATC	1	1.0	GTGTGTTTCAATAGCACTTATGCATCTC	{15729}
3.1144885040667143	3176	3419	243	3176	1	1.0	CTGAAGAAGAGCAAGAAGAAGATTGGTTAG	3389	1	1.0	ATGCAGACATTGTGGAAGAAGCTAAAAAGG	1	1.0	TGATGATAGTCAACAAACTGTTGGTCAA	{3207}
3.1162354666358683	6301	6545	244	6301	1	1.0	CTTTGGAGCACAAAACCAGTTGAAACATCA	6515	1	1.0	TAAAAATTACAGAAGAGGTTGGCCACACAG	1	1.0	GTTTGATGTACTGAAGTCAGAGGACGCG	{6336}
3.1162354666358683	19316	19560	244	19316	1	1.0	CCACACACCAGCTTTTGATAAAAGTGCTTT	19530	1	1.0	TATAACATGATGATCTCAGCTGGCTTTAGC	1	1.0	GCTAATGAGTACAGATTGTATCTCGATG	{19500}
3.1179729605267243	12466	12711	245	12466	1	1.0	GCCAAACTAATGGTTGTCATACCAGACTAT	12681	1	1.0	ACAGAATAATGAGCTTAGTCCTGTTGCACT	1	1.0	CGTGTGATGGTACAACATTTACTTATGC	{12512}
3.1197010878282048	14165	14411	246	14165	1	1.0	GCCTATATTAACCTTGACCAGGGCTTTAAC	14381	1	1.0	TGTTTTATTCTCTACAGTGTTCCCACCTAC	1	1.0	TGCAGAGTCACATGTTGACACTGACTTA	{14195}
3.1197010878282048	19549	19795	246	19549	1	1.0	CTGGCTTTAGCTTGTGGGTTTACAAACAAT	19765	1	1.0	TACCTGTTAATGTAGCATTTGAGCTTTGGG	1	1.0	TGATGGACAACAGGGTGAAGTACCAGTT	{19664}
3.1197010878282048	22225	22471	246	22225	1	1.0	GGCTTTAGAACCATTGGTAGATTTGCCAAT	22441	1	1.0	TGACCCTCTCTCAGAAACAAAGTGTACGTT	1	1.0	GGTATTAACATCACTAGGTTTCAAACTT	{22256}
3.121419948987033	6186	6433	247	6186	1	1.0	CTACACACCCTCTTTTAAGAAAGGAGCTAA	6403	1	1.0	GTCTCTGAAGAAGTAGTGGAAAATCCTACC	1	1.0	GTTTGATGTACTGAAGTCAGAGGACGCG	{6336}
3.121419948987033	24168	24415	247	24168	1	1.0	TGATTGCTCAATACACTTCTGCACTGTTAG	24385	1	1.0	AGCAAGTGCACTTGGAAAACTTCAAGATGT	1	1.0	CGGGTACAATCACTTCTGGTTGGACCTT	{24198}
3.123129642842771	15541	15789	248	15541	1	1.0	CGGCCAATGTTAATGCACTTTTATCTACTG	15759	1	1.0	GGTCTAGTGGCTAGCATAAAGAACTTTAAG	1	1.0	GTGTGTTTCAATAGCACTTATGCATCTC	{15729}
3.123129642842771	23984	24232	248	23984	1	1.0	GATCCATCAAAACCAAGCAAGAGGTCATTT	24202	1	1.0	TACAATCACTTCTGGTTGGACCTTTGGTGC	1	1.0	CTCAATACACTTCTGCACTGTTAGCGGG	{24174}
3.123129642842771	29224	29472	248	29224	1	1.0	GTCGCGCATTGGCATGGAAGTCACACCTTC	29442	1	1.0	AAACTGTGACTCTTCTTCCTGCTGCAGATT	1	1.0	GGGAACGTGGTTGACCTACACAGGTGCC	{29254}
3.1248302666619225	12796	13045	249	12796	1	1.0	GGTAGGTTTGTACTTGCACTGTTATCCGAT	13015	1	1.0	CGTCTACAAGCTGGTAATGCAACAGAAGTG	1	1.0	TTACAGGATTTGAAATGGGCTAGATTCC	{12826}
3.1248302666619225	15599	15848	249	15599	1	1.0	CCGCAATTTACAACACAGACTTTATGAGTG	15818	1	1.0	TATGTCTGAAGCAAAATGTTGGACTGAGAC	1	1.0	GTGTGTTTCAATAGCACTTATGCATCTC	{15729}
