cost	target-start	target-end	target-length	left-primer-start	left-primer-num-primers	left-primer-frac-bound	left-primer-target-sequences	right-primer-start	right-primer-num-primers	right-primer-frac-bound	right-primer-target-sequences	num-guides	total-frac-bound-by-guides	guide-target-sequences	guide-target-sequence-positions
2.5126942636811997	13573	13661	88	13573	1	0.9909255898366606	TGTTAAACCAGAGAGTACAGCTGATCAAGA	13631	1	0.9909255898366606	TATTGCCGTGCGCATATAGAACATCCTGAT	1	0.9872958257713249	GACTTATGGTGGAGCTTCAGTGTGTCTC	{13603}
2.5126942636811997	15003	15091	88	15003	1	0.9945553539019963	GAGGACATCATGTTTTAGTGTCGCTGCACT	15061	1	0.9909255898366606	CGGCCTGGCAATTTTAACCAAGACTTCTAT	1	0.9909255898366606	AACAACTGGTTTGACTTTTCAAACTGTG	{15033}
2.534811090344213	9291	9381	90	9291	1	0.9909255898366606	CTTTGTTTCTCGAGTCTTTGCTAATACAGG	9351	1	0.9909255898366606	ACCCTATAAGAGTTTCTCTGATAGTGGTTG	1	0.9909255898366606	CAGTGTTTGCTACACTCCTATAGATGAG	{9321}
2.5555	26376	26468	92	26376	1	0.9927404718693285	CTCTATGGATTACGTGTCTCTGCTTAATCA	26438	1	0.9909255898366606	CTACTTGTTTGTATATCCCTAAACCCACAG	1	0.9872958257713249	ATTTGGCAGAAGTACCTTAATTCACCGT	{26407}
2.5932573353204815	18076	18172	96	18076	1	0.9909255898366606	TGCTAGCTCTGCCATTAATAGACCACAACT	18142	1	0.9945553539019963	ATGGAGTAAGGCAGTCTTTATTTCGCCTTA	1	0.985480943738657	ACATTTGTGAAGAATTTTATTACTGCAA	{18107}
2.6020405378427527	17937	18034	97	17937	1	0.9945553539019963	TTTTAAGTATGTGCTACAGGTGTCCTAAGG	18004	1	0.9909255898366606	TAAATTGTTAGCCAAGAAGGAGCTTTCAGG	1	0.9836660617059891	AAATAGTAAGCACTGTGAGCTCTCTTGT	{17967}
2.678729642842771	13454	13561	107	13454	1	0.9909255898366606	GTTAACTTCACCGTTGATCCTCAAAAAGCT	13531	1	0.9909255898366606	TAAGATGCTTACTCCTAAAACTGGTACAGG	1	0.9872958257713249	ATCTCGATTTCGTCAATGCGGGAGGTGC	{13485}
2.751623285568201	19764	19883	119	19764	1	0.9909255898366606	GTGAAGTGCATGGTAATGGTAGTATGATAG	19853	1	0.9909255898366606	GGCGCTGTTTGTAGGAAGCATGCTACAGAG	1	0.9836660617059891	CCTAAAATCTGCAGTCTGTATTACAGCT	{19813}
2.7537729313414405	18144	18246	102	18144	1	0.9963702359346642	GGAGTAAGGCAGTCTTTATTTCGCCTTATA	18216	1	0.9909255898366606	CTCAGACTGTTGATTCCTCACAGGGTTCAG	2	0.9818511796733213	CTGTGGCTCGTTCAATTCTGGGTCTTAC GTGGCTCGTTCAATGCTGGGTCTTACTA	{18186} {18188}
2.7623098364064735	9150	9271	121	9150	1	0.9909255898366606	ATGGTATCATGAGCATGTTGGTGGTGTCTA	9241	1	0.9909255898366606	ATTCCAGACGTACCTACTACATTGGCTTGG	1	0.9872958257713249	GACAACTCTATCACATGCCCATTGACAG	{9181}
2.7623098364064735	9257	9378	121	9257	1	0.9909255898366606	CTACATTGGCTTGGGTGAACAATCAGATAA	9348	1	0.9909255898366606	GATACCCTATAAGAGTTTCTCTGATAGTGG	1	0.9909255898366606	TTGTTTCTCGAGTCTTTGCTAATACAGG	{9293}
2.7875643733214486	10878	11004	126	10878	1	0.9927404718693285	GTGGTAGTGTTGGTTACACCAAGGAGGGTA	10974	1	0.9909255898366606	TTGATGGTACTATGTATGGTGCCTTTATGG	1	0.9872958257713249	TGCTAGTGGTACACATACCGGTTCAGCA	{10945}
2.7875643733214486	18076	18202	126	18076	1	0.9909255898366606	TGCTAGCTCTGCCATTAATAGACCACAACT	18172	1	0.9945553539019963	TAATTCACAGAATGCTGTGGCTCGTTCAAT	1	0.985480943738657	ACATTTGTGAAGAATTTTATTACTGCAA	{18107}
2.789829642842771	17971	18078	107	17971	1	0.9909255898366606	AGTAAGCACTGTGAGCGCTCTTGTCTACAA	18048	1	0.9909255898366606	TACTCTATAAGGGCAATGTGACGCATGATG	2	0.9891107078039928	AAGGTGCTTTCAGGCCAGTGCTTTAAAA ATTGTTAGCCAAGAAGGAGCTTTCATGC	{18020} {18007}
2.8064266863651715	14736	14866	130	14736	1	0.9909255898366606	TGATGACCGTTGTGTGTTACATTGTGCTAA	14836	1	0.9909255898366606	GATGGCGTGCCATTTGTAGTATCTTGTGGT	1	0.9836660617059891	GTTTGCTATGACTATGCCTAAGACTTGT	{14778}
2.8109738099539405	19180	19311	131	19180	1	0.9909255898366606	TGCTACTAATCACGATCGTTATTGCTCTGT	19281	1	0.9927404718693285	TAGAACGTGTGGATTGGGATATAGAGTATC	1	0.9872958257713249	ATCAAGGAGCTCATGTGGCTTCTAATGA	{19212}
2.8154573353204815	13633	13765	132	13633	1	0.9909255898366606	TTGCCGTGCGCATATAGAACATCCTGATGT	13735	1	0.9909255898366606	TTGTTTGTCAAATACCCCCTGTAATGTCTG	1	0.9872958257713249	GGGTAAGTTTGTCCAAATCCCTGCTCAG	{13684}
2.836979969342407	6295	6432	137	6295	1	0.9909255898366606	GGGTTTGATTCTAGTAAACCAGTCACTAAG	6402	1	0.9909255898366606	TAAGAATGGTGCCATGTATAAAGGCAAACC	1	0.9872958257713249	CTTGCCTAAAGAAGACGGCGATGTGTTG	{6342}
2.849232422683972	13454	13594	140	13454	1	0.9909255898366606	GTTAACTTCACCGTTGATCCTCAAAAAGCT	13564	1	0.9909255898366606	AGCTATATCTGTTAAACCAGAGAGTACAGC	1	0.9872958257713249	ATCTCGATTTCGTCAATGCGGGAGGTGC	{13485}
2.8648729313414405	16089	16233	144	16089	1	0.9909255898366606	TTCTATGATGATACTGTCTGATGACGGTGT	16203	1	0.9909255898366606	TGTCTTTATGTCTGAAGCTAAATGCTGGGT	1	0.9872958257713249	TTATAATAGTGATTATGCAGCTAAGGGT	{16125}
2.876122044777587	13337	13484	147	13337	1	0.9909255898366606	GTTAAAAATCTTAACAACCTTCATCGCGGG	13454	1	0.9909255898366606	GTTAACTTCACCGTTGATCCTCAAAAAGCT	1	0.9872958257713249	CAAGTGTTAGGGCACATTGCTGCGACTG	{13367}
2.8797857056612073	10726	10874	148	10726	1	0.9909255898366606	TAACCCTAGCACTCCAGCCTACACTTTTAC	10844	1	0.9909255898366606	TACACAATTAAGGGTTCCTTTCTGTGTGGT	1	0.9872958257713249	GCGCAGCATTTAGTGTGTTAGCATGCTA	{10770}
2.8797857056612073	12808	12956	148	12808	1	0.9909255898366606	CGCTAGGAATGGTTGTATACCTCTTAGTGT	12926	1	0.9909255898366606	TACGCTGGGGCTTTGTGGGACATTACAGTT	1	0.9872958257713249	TTCCACTGTGTGCTTCAAATAAACTACG	{12840}
2.8797857056612073	18520	18668	148	18520	1	0.9909255898366606	TAAGACGAGTGATGAGCTTTGCGTGAATCT	18638	1	0.9909255898366606	TTCATTACTCGTGAAGAGGCTGTAAGGCAA	1	0.9836660617059891	GCTGGGCTTTAAACTCGATGCAACAGTT	{18592}
2.91100063353398	9291	9448	157	9291	1	0.9909255898366606	CTTTGTTTCTCGAGTCTTTGCTAATACAGG	9418	1	0.9909255898366606	GAGGGCCGTATGACACCATACTGCCATGAT	1	0.9909255898366606	CAGTGTTTGCTACACTCCTATAGATGAG	{9321}
2.920764845367944	9111	9271	160	9111	1	0.9945553539019963	TGATAAGTGCTTTGCTAATAAGCACCGGTC	9241	1	0.9909255898366606	ATTCCAGACGTACCTACTACATTGGCTTGG	1	0.9818511796733213	TGAGCATGTTGGTGGTGTCTATGACAGC	{9159}
2.927112910986066	15956	16118	162	15956	1	0.9927404718693285	GTGCTAATGGCAACAAGATTGTTGACAAAG	16088	1	0.9909255898366606	TTTCTATGATGATACTGTCTGATGACGGTG	1	0.9818511796733213	GTCAATGTTTATAGGAGCACTAGCCCAG	{16015}
2.939443925003943	13633	13799	166	13633	1	0.9909255898366606	TTGCCGTGCGCATATAGAACATCCTGATGT	13769	1	0.9909255898366606	TATTGGATTGGATATGGGTGCAATTGTGAC	1	0.9872958257713249	GGGTAAGTTTGTCCAAATCCCTGCTCAG	{13684}
2.939443925003943	25861	26027	166	25861	1	0.9909255898366606	GTGGTACATTTGGCTTGGTTTCATTGCTGG	25997	1	0.9909255898366606	GAATACGACCTCGAGCCGCATAAGGTTCAT	1	0.9909255898366606	CTTAGCTCTATGCGTCTTCTTCATACTG	{25900}
2.9424539643783345	19286	19453	167	19286	1	0.9927404718693285	CGTGTGGATTGGGATATAGAGTATCCTTAT	19423	1	0.9909255898366606	TCCTAAAGGAATTCCTATTGTTGATGACCC	1	0.9872958257713249	GTACGTGCTGCTCTTCTTGCCGGTTCAT	{19370}
