cost	target-start	target-end	target-length	left-primer-start	left-primer-num-primers	left-primer-frac-bound	left-primer-target-sequences	right-primer-start	right-primer-num-primers	right-primer-frac-bound	right-primer-target-sequences	num-guides	total-frac-bound-by-guides	guide-target-sequences	guide-target-sequence-positions
3.084923285568201	12293	12471	178	12293	1	1.0	TTCTGGTAGTGGTCAGGCTATTACTAGTAC	12441	1	1.0	CAAGTGCCTATAGGTACAAATGACCCTATA	2	1.0	GGTTTTGTCAGTACAAAGGTAAGTGGGT TTTTTGTCAGTATAAAGGCAAGTGGGTA	{12412} {12413}
3.2904942636811993	26681	26769	88	26681	1	1.0	GTTTCAGACTTTTCCGACGTGCTCGAACTT	26739	2	1.0	AATCACAGTCACAACCGTGCTGGGACAGAC AATCACTGTCACAACCGTGTTGGGACAGAC	2	1.0	TTTGGGCATGGAACCCGGAAGTGAATGC TTTGGGCATGGAATCCTGAGGTTAATGC	{26711} {26711}
3.323122420167963	12380	12471	91	12380	2	1.0	CAGAGCACATGTTGCACATCCAACCATGGA CAGGGCACATGTGGCACACCCAACTATGGA	12441	1	1.0	CAAGTGCCTATAGGTACAAATGACCCTATA	2	1.0	GGTTTTGTCAGTACAAAGGTAAGTGGGT TTTTTGTCAGTATAAAGGCAAGTGGGTA	{12412} {12413}
3.6888006335339796	5746	5903	157	5746	2	1.0	AACGTGACGGTGTGCAAGTTGGTTACTGTG AACGTGATGGTGTGCAAGTTGGTTATTGTG	5873	1	1.0	TTTGAGTGGTGTTGCTTACACTGCTTTTTC	2	1.0	ACCATGGTGTTAAGTATTACTCACGAGT CCCATGGTATTAAGTACTATTCACGTGT	{5776} {5776}
3.817675799801318	11243	11448	205	11243	2	1.0	CGCATCATCTTTTGTTGGTATGCCGTCTTT TGCATCGTCTTTTGTTGGTATGCCATCTTT	11418	1	1.0	AGAATGGCTGAACAAGCTGCTGCAGCTATG	2	1.0	GCTAAGGCTGAGTTTGACAGAGAGTCGT TGTGGCATACGAAACAGCAAGACAAGAG	{11370} {11273}
3.881601953228442	12293	12530	237	12293	1	1.0	TTCTGGTAGTGGTCAGGCTATTACTAGTAC	12500	2	1.0	AGTCTGTGGTTGCTGGCTCAATCATGGTTG AGTTTGTGGTTGTTGGCTTAATCATGGCTG	2	1.0	TCAGTATAAAGGCAAGTGGGTACAAGTG TTTTTGTCAGTACAAAGGTAAGTGGGTA	{12419} {12413}
3.8834079683607334	12233	12471	238	12233	2	1.0	TGATGCTGTTAAACAAGGCGCAAAACCTGT TGATGCTGTTAGACAAGGTGCAAAACCCGT	12441	1	1.0	CAAGTGCCTATAGGTACAAATGACCCTATA	2	1.0	GGTTTTGTCAGTACAAAGGTAAGTGGGT TTTTTGTCAGTATAAAGGCAAGTGGGTA	{12412} {12413}
3.9981897580044534	233	338	105	233	1	1.0	TCTGTCTCGTGTTTGTGTGGAAGCAAAGTT	308	3	1.0	TGTGACACTTGCCGTAGCAAGTGATACTGA TGTGACACTTGCTGTTGCAAGTGATACTGA TTTTACACTTGCCGTTGCAAGTGATTCTGA	1	1.0	GGTAACTGTTCCTAATGGCCTGCAACCG	{280}
4.234329642842771	26751	26858	107	26751	2	1.0	AACCGTGCTGGGACAGACGTACTACCAACC AACCGTGTTGGGACAGACATACTATCAACC	26828	2	1.0	TGCTTTACGTGGACGGACATAGATTGGCTT TTCTTTACGTGGACGGCCATAGAATCGCTT	3	1.0	CAGGCATCACGGTGACCTTGCTGAGCGG CAGGCATTACGGTGACCTTGTTGAGCGG GGGATCACAGTAACCCTGTTGAGCGGTG	{26798} {26798} {26800}
4.323122420167964	26894	27016	122	26894	3	1.0	CAGTTGCCGTGCCGAGCACTACTATAATTT CAGTTGCCGTGCCTAGTACTACTATAATTT CGGTTGCCGTGCCGAGCACTACTATTATTT	26986	1	1.0	GTAAAACACGGTGACTTTTCTGCAGTGAGC	3	1.0	AGTAGAGTCGGAAGGTCCGTAAATTCTC GTAGAGTCGGAAGGTCCGTAAATTCACG GTAGGGTCGGGAGGTCTGTCAATTCACG	{26926} {26927} {26927}
4.358788527362399	12380	12538	158	12380	2	1.0	CAGAGCACATGTTGCACATCCAACCATGGA CAGGGCACATGTGGCACACCCAACTATGGA	12508	2	1.0	GTTGCTGGCTCAATCATGGTTGTACTTGTG GTTGTTGGCTTAATCATGGCTGTACATGTG	2	1.0	TCAGTATAAAGGCAAGTGGGTACAAGTG TTTTTGTCAGTACAAAGGTAAGTGGGTA	{12419} {12413}
4.3778377053709505	25275	25439	164	25275	2	1.0	CAAGTGGCCGTGGTGGGTGTGGTTGTGCAT TAAGTGGCCATGGTGGGTGTGGTTGTGTAT	25409	2	1.0	GCGAATCAACTAAACTTCCTTATTACGACG GTGAGTCAACTAAACTTCCTTATTACGACG	2	1.0	GTCGTGCTCATCTTTGTGGTGAGTATGT TGTGGCTGTTGTAGTTGTTTATCGTCGT	{25309} {25366}
4.392890556965432	16626	16795	169	16626	1	1.0	GTGCTATAGGACCTGATGTCTTTTTACACA	16765	3	1.0	ACGCGGTAGTGTTCAGGTAGACAATGGCTC ACGTGGTAGTGTACAGGTGGACAATGGTTC ACGTGGTAGTGTGCAGGTAGATAATGGTTC	2	1.0	CCAGTCAAAGAGGCCAGTAAGCAGTGCT GTTTGTACCTGTCAAAGAAGCTAGTAAG	{16724} {16717}
4.429009836406473	13099	13281	182	13099	3	1.0	ATGTGTTGCGCTTTGTGACGAAATGGTTCG GTGTGTTGCTCTTTGCGACGAAATGGTGCT GTGTGTTGCTTTTTGCGATGAAATGGTGCT	13251	1	1.0	CTTATATGATGCCTGTTATGGGTATGACCA	2	1.0	GTGTCCTCCTGGAATGGGAATACCCTAC TGACTTTGGGGACTTCGTTTTGTGTCCT	{13207} {13186}
4.469888527362399	5881	6039	158	5881	1	1.0	GTGTTGCTTACACTGCTTTTTCTGGACCTG	6009	3	1.0	TCAGTTGTTATGGTAGGGGGTTATGTGGCT TCAGTTGTTATGGTGGGAGGCTATGTCGCA TCAGTTGTTATGGTTGGTGGTTATGTTGCA	3	1.0	TGTTTATGACACCGCAAAGAAGTCAATG TGTTTATGATGCTGCTAAAAAGTCAATG TTTATGATACTGCAAAGAAATCAATGTA	{5930} {5930} {5932}
4.511900082244952	12380	12598	218	12380	2	1.0	CAGAGCACATGTTGCACATCCAACCATGGA CAGGGCACATGTGGCACACCCAACTATGGA	12568	2	1.0	GTTATTTAAACGAGTCAGGGGCTCTAGTGC GTTATTTAAACGAGTCCGGGGTTCTAGTGC	2	1.0	TCAGTATAAAGGCAAGTGGGTACAAGTG TTTTTGTCAGTACAAAGGTAAGTGGGTA	{12419} {12413}
4.5624729605267245	9769	10014	245	9769	1	1.0	GCTTTGATGGTGTTATGTATGGTGGTTTTG	9984	3	1.0	TTCTCCATTCTTGCTGCTAAAACTGGCGTT TTTTCCATTCTTGCTGCTAAAACTGGTGTC TTTTCTATTCTTGCTGCAAAAACCGGTGTC	2	1.0	ACATGGTGGCTTAAAGGCGACAAATTGT ACCAGATGCTAACAGTTAATGTGGTCGC	{9891} {9832}
4.567629642842771	12380	12628	248	12380	2	1.0	CAGAGCACATGTTGCACATCCAACCATGGA CAGGGCACATGTGGCACACCCAACTATGGA	12598	2	1.0	CGCTCGACTAGAACCCTGTAATGGTACAGA CGCTCGACTAGAGCCCTGCAATGGTACAGA	2	1.0	TCAGTATAAAGGCAAGTGGGTACAAGTG TTTTTGTCAGTACAAAGGTAAGTGGGTA	{12419} {12413}
4.668331969052151	13039	13281	242	13039	3	1.0	TGAGGACATACACCGCGTGTACGCTGCTTT TGAGGACATACACCGTGTATACGCTGCTTT TGAGGACATACACCGTGTGTATGCTGCTTT	13251	1	1.0	CTTATATGATGCCTGTTATGGGTATGACCA	3	1.0	TGTTGCGCTTTGTGACGAAATGGTTCGC TGTTGCTCTTTGCGACGAAATGGTGCTT TGTTGCTCTTTGCGATGAAATGGTGCTT	{13102} {13102} {13102}
4.92217380995394	13150	13281	131	13150	4	1.0	AACTCTAGACAACCAGGATCTTAATGGGAA GACCCTCGATAATCAGGATCTCAATGGGAA GACCTTAGACAACCAAGATCTTAATGGGAA GACCTTAGATAACCAAGACCTTAATGGGAA	13251	1	1.0	CTTATATGATGCCTGTTATGGGTATGACCA	2	1.0	GTGTCCTCCTGGAATGGGAATACCCTAC TGACTTTGGGGACTTCGTTTTGTGTCCT	{13207} {13186}
4.976072931341441	12910	13054	144	12910	3	1.0	GGACTTGTGCTTTGCTCTGCGTAACTTTGA GGATTTGTGCTTCGCTCTGCGTAACTTTGA GGATTTGTGTTTTGCCCTGCGTAATTTTGA	13024	2	1.0	TGACCCAGTAGAAAATGAGGACATACACCG TGACCCCATAGAAAATGAGGACATACACCG	2	1.0	CTGATTACTTTGAAATGAAGAATTGGTT TTCTTACTGGTTGTTGTGGTACCGATTA	{12996} {12975}
5.0	12643	12831	188	12643	2	1.0	CCGTGCATTTGACGTTTACAACAAAGACGC CCGTGCATTTGACGTTTACAATAAAGATGC	12801	3	1.0	TACTTAAAAACTGCGATGCTGTCGCAAAGC TACTTAAAGGCTGTAATGCTATTGCCAAGC TACTTAAAGGCTGTAATGCTGTTGCTAAGC	1	1.0	CTTGAAGTCCAATTGTGTGCGCTTCAAG	{12691}
5.012129642842771	5797	5904	107	5797	4	1.0	CACGAGTCAGGAGTGTTAGTGGGCGTGCCA CACGTGTTAAAAGTGTTAGAGGTAGAGCTA CACGTGTTAAGAGTGTCAGTGGTAGAGCCA CACGTGTTAGAAGTGTTAGCGGTAGAGCTA	5874	1	1.0	TTGAGTGGTGTTGCTTACACTGCTTTTTCT	4	1.0	GCTTGAACCATGTTCTCAGTCTAGACTT GTCAGTGTCGAACAGCTTGAACCGTGTG TCATAGTAGGTGTTGAACAAATTGAACC TCATAGTTAGTGTAGAGCGTCTTGAACC	{5846} {5832} {5827} {5827}
5.028726686365172	9769	9899	130	9769	1	1.0	GCTTTGATGGTGTTATGTATGGTGGTTTTG	9869	4	1.0	TGCGGCTATATTGAATGGTTGCACCTGGTG TGCTGCCATACTGAATGGTTGTACATGGTG TGCTGCTATATTGAATGGTTGCACATGGTG TGCTGCTATATTGAATGGTTGCATATGGTG	3	1.0	AACCAGATGCTAACAGTCAATGTGGTAG ACCAGATGCTAACAGTTAATGTGGTCGC CTTCAAGTTGAATCTGCAAGTCAAATGT	{9831} {9832} {9813}
5.028743040981689	26751	26910	159	26751	2	1.0	AACCGTGCTGGGACAGACGTACTACCAACC AACCGTGTTGGGACAGACATACTATCAACC	26880	3	1.0	ACCTGAACACATGACAGTTGCCGTGCCGAG ACCTGAATACATGACAGTTGCCGTGCCGAG ACCTGAGTACATGTCGGTTGCCGTGCCGAG	2	1.0	GGGATCACAGTAACCCTGTTGAGCGGTG GTGCTTTACGTGGACGGACATAGATTGG	{26800} {26827}
5.057191578646307	7586	7799	213	7586	2	1.0	GCGCGCTGGTGCTAAGACTGTTAATGCTAA GCGTGCAGGTGCTAAGGTTGTTAATGCCAA	7769	3	1.0	ACCTGCAACCAGCATTGTTGCTAAACAAGG ACCTGCAACTAGCATTGTTGCTAAGCAAGG ACCTGCTACTAGCATCTTATCTAAACAAGG	1	1.0	TAACAGTCTGTCTGCTGAAGGTCGCAAG	{7664}
5.079543377117346	12129	12305	176	12129	4	1.0	GGCGCTACTGTGAGATTGCAAGCTGGTAAA GGTGCCACTGTCAGATTGCAAGCTGGTAAA GGTGCCACTGTGAGATTGCAAGCTGGCAAA GGTGCTACTGTTAGACTGCAAGCTGGTAAA	12275	1	1.0	AAAGATGTTGACTAATGGTTCTGGTAGTGG	2	1.0	CAGACTGAGTTTGTTTCAAATTCCCATT TTTCAAATTCCCTTTTGTTAACTCATTG	{12159} {12172}
5.1110657561098884	12639	12880	241	12639	1	1.0	GTGTCCGTGCATTTGACGTTTACAATAAAG	12850	4	1.0	TGAAGGCAGAACCATCTATGGTAACGTTAG TGAAGGCCGAACCATCTATGGTAATGTTAG TGAGGGCAGAACCATCTATGGTAATGTTAG TGAGGGCAGAACCATTTATGGTAATGTTAG	1	1.0	CTTGAAGTCCAATTGTGTGCGCTTCAAG	{12691}
5.1135946961550465	11498	11687	189	11498	2	1.0	GCATAGTTTACTCTTTGGCATGCTCCGACG GCATCGCTTACTCTTTGGCATGCTCCGTAG	11657	3	1.0	AATGATGGTAGATGGTTTTGTGCACTACGC AATGATGGTAGATGGTTTTGTTCACTACGC AATGTTGGTAGATGGTTTTGTGCACTATGC	2	1.0	GTCGTCGTGGTGCCAGATCATGATTCAT GTCGTTGTAGTACCAGATCATGATTCAT	{11622} {11622}
5.118526590941621	9056	9247	191	9056	2	1.0	CTCTCCAGAAAAGTTGAAAAGTTATGCTGC TTCGCCAGATAAGTTGAAAAGTTATGCAGC	9217	3	1.0	CAACAGTTAGTTATGGTTCGACCTTGCAAG CAACTGTCAGTTATGGGTCTACATTACAAG CAACTGTCAGTTATGGTTCTACATTACAGG	2	1.0	CCTATTTAGCGAAAGCAATGTTGGACTT TGGACTTTTCGCGTGATCATAATGACAT	{9154} {9175}
5.132882728833828	25242	25439	197	25242	3	1.0	CCTTGAGTGGCTCAACCGTGTAGAAAACTA CTTAAAGTGGCTCAACCGGGTTGAGACTTA TCTTGAGTGGCTCAACCGTGTTGAGACTTA	25409	2	1.0	GCGAATCAACTAAACTTCCTTATTACGACG GTGAGTCAACTAAACTTCCTTATTACGACG	2	1.0	GTGGGTTTGGTTGTGCATTTCAGTCGCG TGTGGCTGTTGTAGTTGTTTATCGTCGT	{25287} {25366}
5.148857335320481	16723	16927	204	16723	3	1.0	ACCAGTCAAAGATGCCAGTAAGCAGTGCTT ACCCGTCAAAGAGGCTAGTAAGCAGTGCTT ACCTGTCAAAGAAGCTAGTAAGCAGTGCTT	16897	2	1.0	TGTAGCTGCTAGGCTTTTAGGTTTACAAAC TGTCGCTGCTAGACTTTTGGGTTTGCAAAC	2	1.0	AAAATCTTTGAACGTGGTAGTGTGCAGG ACTTGATGTTGTTAAGCGATTTATACAT	{16754} {16813}
5.15327901698314	9776	9982	206	9776	2	1.0	TGGTGTTATGTATGGCGGTTTTGATGACCA TGGTGTTATGTATGGTGGTTTTGAAGACCA	9952	3	1.0	ATGGTTTCACAGCTATGAATGGTGAAGACG ATGGTTTTACAGCCATGAATGGTGAAGATG ATGGTTTTACAGCTATGAATGGCGAAGATG	2	1.0	ACATGGTGGCTTAAAGGCGACAAATTGT ACCAGATGCTAACAGTTAATGTGGTCGC	{9891} {9832}
5.159799245246692	16626	16835	209	16626	1	1.0	GTGCTATAGGACCTGATGTCTTTTTACACA	16805	4	1.0	AGACGCCAACTTGATGTTGTTAAGCGATTT AGGCGCCAACTCGATGTTGTCAAGCGATTT AGGCGTCAACTTGATGTTGTTAAGCGATTT CGTCGACAACTTGACGTCGTCAAGCGTTTT	2	1.0	CCAGTCAAAGAGGCCAGTAAGCAGTGCT GTTTGTACCTGTCAAAGAAGCTAGTAAG	{16724} {16717}
5.188587395870145	19084	19307	223	19084	2	1.0	CTCTGCTACTGCTGTGAAAGCAGGTGGTAA CTCTGTTACTGCTGTTAAAACAGGTGGTAA	19277	3	1.0	AACCTCCAAGACTTTTTACCGCGTAGCACA AACTTACAAGACTTTTTGCCCCGTAGCACA AATTTACAAGACTTTTTGCCTCGCAGCACA	2	1.0	ATTTGCCAGCCATTCGGTTAAATTTTGG TTGCCGGCTATTAAATTGAATTTTGGAA	{19116} {19118}
5.1944337616452865	16556	16782	226	16556	2	1.0	GCCCCTAGGGTGCTTATATCCAAAGGAACT GCTCCTAGAGTTCTTATCTCTAAAGGTGTT	16752	3	1.0	TCAAAATCTTTGAACGCGGTAGTGTTCAGG TCAAAATCTTTGAACGTGGTAGTGTGCAGG TTAAGATCTTTGAACGTGGTAGTGTACAGG	2	1.0	CCAGTCAAAGAGGCCAGTAAGCAGTGCT GTTTGTACCTGTCAAAGAAGCTAGTAAG	{16724} {16717}
5.202066666009797	281	511	230	281	1	1.0	GTAACTGTTCCTAATGGCCTGCAACCGTGT	481	4	1.0	TGGGTCTGACCGGCGACCAACCACTGGTTT TGGGTCTGCATGGCAATCAGACGTTGTTTT TGGGTCTGCATGGTAACCAAACGTTGTTCT TGGGTTTGCATGGTAACCAAACGTTGTCCT	2	1.0	CCACCGTTGCTCAAGCCGTCCGCCTTTA GCGCTAGCCGTCCGCCGCTATAGCGAGG	{358} {366}
5.227435466635868	8996	9240	244	8996	3	1.0	TGCTGCAGCTGGTACATTTGTGATTGACAT TGCTGCTGCAGGAACATTTGTTATTGACAT TGCTGCTGCAGGTACGTTTGTTCTAGACAT	9210	2	1.0	ACACCACCAACAGTTAGTTATGGTTCGACC ACACCTCCAACTGTCAGTTATGGTTCTACA	2	1.0	CCTATTTAGCGAAAGCAATGTTGGACTT TGGACTTTTCGCGTGATCATAATGACAT	{9154} {9175}
5.229172960526724	16723	16968	245	16723	3	1.0	ACCAGTCAAAGATGCCAGTAAGCAGTGCTT ACCCGTCAAAGAGGCTAGTAAGCAGTGCTT ACCTGTCAAAGAAGCTAGTAAGCAGTGCTT	16938	2	1.0	ATTCTGCTCAAGGCAGTGAATATGACTATG ATTCTGCTCAAGGTAGCGAGTATGACTATG	2	1.0	AAAATCTTTGAACGTGGTAGTGTGCAGG ACTTGATGTTGTTAAGCGATTTATACAT	{16754} {16813}
5.234329642842771	16773	16927	154	16773	3	1.0	GTGTACAGGTGGACAATGGTTCCAGTATAA GTGTGCAGGTAGATAATGGTTCCAGTATAA GTGTTCAGGTAGACAATGGCTCCAGTATAA	16897	2	1.0	TGTAGCTGCTAGGCTTTTAGGTTTACAAAC TGTCGCTGCTAGACTTTTGGGTTTGCAAAC	4	1.0	ACTTGATGTTGTTAAGCGATTTATACAT GGCGTCAACTCGATGTTGTCAAGCGATT GGCGTCAACTTGATGTTGTTAAGCGGTT GTCGACAACTTGACGTCGTCAAGCGTTT	{16813} {16806} {16806} {16806}
5.241634243325826	8876	9072	196	8876	3	1.0	ATGGTGGCTGTGTGCTTGGTACTTTCTTGC ATGGTGGTTGTGTACTTGGTACTTTTTGGC GTGGTGGCTGTGCGCCTGGTACTTTTTATC	9042	2	1.0	CTTGCTAACAGCATTTCGCCAGATAAGTTG CTTGCTAATAGCATCTCTCCAGAAAAGTTG	3	1.0	ACCTAGTTTGTTGAAGCTTAAAGTCTCG CTTACGGGTTTGTTGCCAAGTTTGTTGA TTAACAGGTTTGTTACCCAGTTTGTTGA	{8924} {8910} {8910}
5.277289493487165	13024	13236	212	13024	2	1.0	TGACCCAGTAGAAAATGAGGACATACACCG TGACCCCATAGAAAATGAGGACATACACCG	13206	3	1.0	TGTGTCCGCCTGGAATGGGAATACCTTATT TGTGTCCTCCTGGAATGGGAATACCCTACT TGTGTCCTCCTGGTATGGGAATACCCTATT	3	1.0	TGTTGCGCTTTGTGACGAAATGGTTCGC TGTTGCTCTTTGCGACGAAATGGTGCTT TGTTGCTCTTTGCGATGAAATGGTGCTT	{13102} {13102} {13102}
5.279391578646307	11925	12138	213	11925	2	1.0	GGACGTGCATTTATGTATGCATATGTGACT GGCCGTGCATTTATGTATGCGTATGTGACC	12108	3	1.0	GGTGCTGTTTTGGGTTACATAGGCGCTACT GGTGCTGTTTTGGGTTACATTGGTGCCACT GGTGCTGTTTTGGGTTATATCGGTGCTACT	3	1.0	GTTAAATGGGAACATGAATCGGGTGTGG TCCGGCGTGGTTACAGTAGAACTAGAAC TTAAATGGGAGCATGACTCTGGTGTGGT	{11976} {11994} {11977}
5.331489758004454	19449	19689	240	19449	3	1.0	GCCTAGGTAAGATGGGCATCCTTAAAGCTG GCCTGAGTAAAATGGGCATCTTGAAGGCTG GTCTGAGTAAAATGGGCATCTTGAAGGCAG	19659	2	1.0	AACCATGGAGATGGATGCTATGGTGTAAAG AACCATGGCGATGGATGCTTTGGTGTAAAG	3	1.0	AAGAATTTGTGGCAGCATCTGACGTAAC AGAGTTTGCTGCTGCGTCTGATGTAACA CTATATTGAAGTCTTTGGATTTGACCGT	{19479} {19480} {19596}
5.347130266661923	11925	12174	249	11925	2	1.0	GGACGTGCATTTATGTATGCATATGTGACT GGCCGTGCATTTATGTATGCGTATGTGACC	12144	3	1.0	CTGCAGGCTGGTAAACAAACTGAGTTTGTT TTGCAAGCTGGCAAACAGACTGAGTTCGTT TTGCAAGCTGGTAAACAGACTGAGTTTGTT	3	1.0	GTTAAATGGGAACATGAATCGGGTGTGG TCCGGCGTGGTTACAGTAGAACTAGAAC TTAAATGGGAGCATGACTCTGGTGTGGT	{11976} {11994} {11977}
5.350368425664694	16773	16968	195	16773	3	1.0	GTGTACAGGTGGACAATGGTTCCAGTATAA GTGTGCAGGTAGATAATGGTTCCAGTATAA GTGTTCAGGTAGACAATGGCTCCAGTATAA	16938	2	1.0	ATTCTGCTCAAGGCAGTGAATATGACTATG ATTCTGCTCAAGGTAGCGAGTATGACTATG	4	1.0	ACTTGATGTTGTTAAGCGATTTATACAT GGCGTCAACTCGATGTTGTCAAGCGATT GGCGTCAACTTGATGTTGTTAAGCGGTT GTCGACAACTTGACGTCGTCAAGCGTTT	{16813} {16806} {16806} {16806}
5.371157335320482	26814	26910	96	26814	3	1.0	CCTGTTGAGCGGTGTTCTTTACGTGGACGG CTTGCTGAGCGGTGTGCTTTACGTGGACGG CTTGTTGAGCGGCGTGCTTTACGTGGACGG	26880	3	1.0	ACCTGAACACATGACAGTTGCCGTGCCGAG ACCTGAATACATGACAGTTGCCGTGCCGAG ACCTGAGTACATGTCGGTTGCCGTGCCGAG	2	1.0	ACATAGATTGGCTTCAGGTGTTCAGGTT ATCGCTTCAGGTATTCAGGTTCATAATT	{26844} {26851}
5.388489493487164	19084	19182	98	19084	2	1.0	CTCTGCTACTGCTGTGAAAGCAGGTGGTAA CTCTGTTACTGCTGTTAAAACAGGTGGTAA	19152	4	1.0	ACGGTAATGCAATTGCTACTGTCAAATCAG ATGGTAATCCTGTAGCAACAGTTAAGGCAG ATGGTAATGCCATTGCTACTGTCAAATCAG ATGGTAATGCCGTCGCTACTGTCAAATCAG	2	1.0	ATTTGCCAGCCATTCGGTTAAATTTTGG TTGCCGGCTATTAAATTGAATTTTGGAA	{19116} {19118}
5.412748055426138	9166	9390	224	9166	3	1.0	AAGCAATGCTGGATTTTTCGCGTGATCATA AAGCAATGTTGGACTTTTCGCGTGATCATA AGGCCATGATGGACTATTCGCGTGATCATA	9360	2	1.0	CCACGGCACGTTATCGCATCTAATACAACT CCACGTCATGTTATTGCATCTAACACAACT	4	1.0	ATACACACCTCCAACTGTCAGTTATGGG CGGTTCTACATTACAGGCAGGTTTGCGT GGTTCGACCTTGCAAGCAGGTTTGCGTA TCAGTTACGGTTCTACATTACAGGCAGG	{9206} {9230} {9231} {9223}
5.412848055426138	12639	12740	101	12639	1	1.0	GTGTCCGTGCATTTGACGTTTACAATAAAG	12710	5	1.0	CGCTTCAAAAATGCAGATAAAGATGATGCG CGCTTCAAGAACGCAGATAAGGATGATGCG CGCTTCAAGAATGCAGATAAGGACGATGCG CGCTTCAAGAATGTAGATAAGGATGACGCG CGCTTCAGAAATGCTGATAAGGATGATGCG	2	1.0	CGGAAAAAATCTGAAGTCCAATTGTGTG TGCTTCTTTTATCGGCAAAAACTTGAAG	{12682} {12670}
5.4223754107419015	16773	17002	229	16773	3	1.0	GTGTACAGGTGGACAATGGTTCCAGTATAA GTGTGCAGGTAGATAATGGTTCCAGTATAA GTGTTCAGGTAGACAATGGCTCCAGTATAA	16972	2	1.0	ATTCGCACAGACATCAGATACTGCTCATGC ATTTGCACAAACATCAGATACTGCTCATGC	4	1.0	ACTTGATGTTGTTAAGCGATTTATACAT GGCGTCAACTCGATGTTGTCAAGCGATT GGCGTCAACTTGATGTTGTTAAGCGGTT GTCGACAACTTGACGTCGTCAAGCGTTT	{16813} {16806} {16806} {16806}
5.424266666009797	18882	19112	230	18882	3	1.0	CCCTCAGTATTCTCAAAAACCTCGGTGTTG CTCTCAGTATTCTCAAAAACCTTGGTGTTG CTCTTAGCATTCTTAAGAACCTAGGTGTTG	19082	2	1.0	TTCTCTGCTACTGCTGTGAAAGCAGGTGGT TTCTCTGTTACTGCTGTTAAAACAGGTGGT	4	1.0	ACAAGTTTTACTAAGTCTGTTTGTGGTT AGGTTCTTATGAACGTTTTACTCTGTCA GAACGTCCTCTAACTAGTTTCACTAAGT TTACAAGCTTTACTAAGGCTGTTTGTGG	{18962} {19039} {18950} {18960}
5.4518265909416215	6305	6496	191	6305	1	1.0	TAAGTGGTGGCTGCTTGCTAAGTTTATGAA	6466	4	1.0	GCGGTAATTCATTGGGCTGTAAGATGTGTC GTGAAGGTTCACTAGGTTGTAAAATGTGTC GTGATGGTTCATTGGGCTGCAAGATGTGTC GTGATGGTTCATTGGGCTGTAAAATGTGTC	5	1.0	CTACTGTTACTTATATATACATTGTATT CTCATCTATACATTGTACTCAGTAGTTT CTCATTTACACGTTGTATTCAGTAGTTT CTTGGTGTACGCTTTGGACCATTTAATG GTTTATGTTACTTGTGTACACACTGTAT	{6336} {6345} {6345} {6375} {6335}
5.499589493487164	5727	5825	98	5727	2	1.0	ATAGTATGTGCTGGTGTTAAACGTGATGGT ATAGTTTGTGCTAGTGTCAAACGTGATGGT	5795	4	1.0	CTCACGAGTCAGGAGTGTTAGTGGGCGTGC TTCACGTGTTAAAAGTGTTAGAGGTAGAGC TTCACGTGTTAAGAGTGTCAGTGGTAGAGC TTCACGTGTTAGAAGTGTTAGCGGTAGAGC	3	1.0	GTGCAAGTTGGTTATTGTGCCCATGGCA TGCAAGTTGGCTATTGTGACCATGGTGT TTGGTTATTGTGCCCATGGTATTAAGTA	{5757} {5758} {5764}
5.545422420167963	15740	15862	122	15740	4	1.0	GAAACGGTCAAGGCTAAAGAGGAAAGTGTT GAAACTGTCAAAGCTAAGGAGGAAAGTGTT GAAACTGTCAAGGCTAAAGAAGAAAGTGTG GAGACTGTGAAAGCTAAAGAGGAAAGCGTT	15832	2	1.0	ATGGGAAAGTGGAAAAGCCAAACCACCGTT ATGGGAAAGTGGAAAAGCCAAACCGCCATT	2	1.0	TTGTAGGTCCTAAGGAACTTTTGCTCTC TTGTAGGTCCTAAGGAATTTTTGCTCTC	{15804} {15804}
5.584326686365171	12129	12259	130	12129	4	1.0	GGCGCTACTGTGAGATTGCAAGCTGGTAAA GGTGCCACTGTCAGATTGCAAGCTGGTAAA GGTGCCACTGTGAGATTGCAAGCTGGCAAA GGTGCTACTGTTAGACTGCAAGCTGGTAAA	12229	2	1.0	ATCTTGATGCTGTTAAACAAGGCGCAAAAC ATCTTGATGCTGTTAGACAAGGTGCAAAAC	2	1.0	CAGACTGAGTTTGTTTCAAATTCCCATT TTTCAAATTCCCTTTTGTTAACTCATTG	{12159} {12172}
5.593357335320481	16663	16795	132	16663	3	1.0	CAGATGTCCTGCTGAAATAGTTAACACTGT CAGGTGTCCAGCTGAAATAGTTAACACTGT CAGGTGTCCTGCTGAAATAGTTAATACTGT	16765	3	1.0	ACGCGGTAGTGTTCAGGTAGACAATGGCTC ACGTGGTAGTGTACAGGTGGACAATGGTTC ACGTGGTAGTGTGCAGGTAGATAATGGTTC	2	1.0	CCAGTCAAAGAGGCCAGTAAGCAGTGCT GTTTGTACCTGTCAAAGAAGCTAGTAAG	{16724} {16717}
5.597779016983139	11671	11804	133	11671	3	1.0	GCTTTGTTCACTACGCAGGTGTTGTTTGGA GTTTTGTGCACTACGCTGGCGTTGTTTGGA GTTTTGTTCACTACGCGGGTGTTGTTTGGA	11774	3	1.0	ACTTGTCTGGCCTCTGATTTTGACATGCGA ACTTGTTTGGCCTCTGATTTTGACTTGTGA ACTTGTTTGGCCTTTGGTTTTGACATGTGA	2	1.0	CAAGAGGTTAAAGACAATGATGGTAGGA TAAAGATGTTACAAAGGAAAACCAGGAA	{11706} {11744}
5.609253964378334	7632	7799	167	7632	3	1.0	CAAACACCTATTGTCTGGCATGCTAAGGAT CAAACTCCTATTGTTTGGCATGCAAAGGAT CAAACTCCTATTGTTTGGCATGCTAGAGAT	7769	3	1.0	ACCTGCAACCAGCATTGTTGCTAAACAAGG ACCTGCAACTAGCATTGTTGCTAAGCAAGG ACCTGCTACTAGCATCTTATCTAAACAAGG	1	1.0	TAACAGTCTGTCTGCTGAAGGTCGCAAG	{7664}
5.612236002980723	26958	27126	168	26958	2	1.0	CAACACAGGTTGGATGTTTTATGTCAGAGT CAGCACAGGCTGGGTTTTCTACGTACGAGT	27096	4	1.0	TGGGCTGATGAGTCTGAGCAGCAGCGTGGT TGGGCTGATGCATCTGAACCACAACGTGGT TGGGCTGATGCTTCTGAACCACGGCGTGGT TGGGCTGATTCCTCTGAACCACAACGTGGT	1	1.0	CACGGTGACTTTTCTGCAGTGAGCTCAC	{26992}
5.686134243325825	25311	25439	128	25311	4	1.0	CGCGCTCATCTTTGTGGTGAGTATGTTACT CGTGCTCATCTTTGTGGTGAGTATTTTGCT TGTCCTAATTTTTACTGTGGGCTTGCTCTT TGTGTTGATTTTTGTGGTGGGCTTGCTGAT	25409	2	1.0	GCGAATCAACTAAACTTCCTTATTACGACG GTGAGTCAACTAAACTTCCTTATTACGACG	3	1.0	CTGCGGCTTCTTTAGTTGTTTTGCATCT GCTGTGGTTTCTTTAGTTGTCTTGCTTC TGTGGCTGTTGTAGTTGTTTATCGTCGT	{25365} {25364} {25366}
5.690814134296109	8876	9005	129	8876	3	1.0	ATGGTGGCTGTGTGCTTGGTACTTTCTTGC ATGGTGGTTGTGTACTTGGTACTTTTTGGC GTGGTGGCTGTGCGCCTGGTACTTTTTATC	8975	3	1.0	ATTTGTAGGTACATTTGAAAGTGCTGCTGC GTTCGTAGGCACATTTGAAAGTGCTGCTGC GTTTGTGGGTACATTCGAAAGTGCTGCAGC	3	1.0	ACCTAGTTTGTTGAAGCTTAAAGTCTCG CTTACGGGTTTGTTGCCAAGTTTGTTGA TTAACAGGTTTGTTACCCAGTTTGTTGA	{8924} {8910} {8910}
5.692188527362399	9464	9622	158	9464	2	1.0	CCTTGGCGTTGTAGGTGCTACTATGCATGG TCTTGGTGTTGTAGGTGCTACTATGCATGG	9592	4	1.0	GCTATGATGGTTGTGCCCAAGGTGTCTTTG GCTATGATGGTTGTGCTCAGGGTGTTTTTG GTTATGATGGTTGTGCACATGGTGTTTTTG GTTATGATGGTTGTGCCCAAGGTGTTTTCG	2	1.0	AAATTAAGGTGTCACAGACTAACATGCA TCTTAGAATTAAAGTCTCACAGACTAAC	{9505} {9500}
5.701854591467448	17993	18154	161	17993	3	1.0	GACTGGTCAATAACCTACCCTATGATAGCT GACTGGTCAATTACCTATCCTATGATAGCT GATTGGTCAATTACCTACCCTATGATAGCT	18124	3	1.0	TCCTAAAGGTATTCGTTGTGCCGTAACAAA TCCTAAGGGTATTCGTTGTGCCGTGACTGA TCCTAAGGGTATTCGTTGTGCTGTAACTGA	2	1.0	CGTGTGGTACAGAGTCATATTATGCGCG TGCAAAGTCATATCATGCGTGCTGCTAT	{18050} {18057}
5.717343925003942	11167	11333	166	11167	3	1.0	TGTCTAAGCATAGTGATTTTGGACTCGGTG TGTCTAAGCATAGTGATTTTGGTCTTGGCG TGTCTAAGCATAGTGATTTTGGTCTTGGTG	11303	3	1.0	TGAAAACGCAGTTGCAAATGGATCGTCACC TGAAAATGCTGTTGCAAATAGTTCCTCACC TGAAAATGCTGTTGCAAATGGTTCTTCACC	2	1.0	GCATCATCTTTTGTTGGTATGCCGTCTT TCGTCTTTTGTTGGTATGCCATCTTTTG	{11244} {11247}
5.734200082244953	13024	13163	139	13024	2	1.0	TGACCCAGTAGAAAATGAGGACATACACCG TGACCCCATAGAAAATGAGGACATACACCG	13133	4	1.0	GGAGTTGTTGGTGTCCTAACTCTAGACAAC GGAGTTGTTGGTGTCTTGACCTTAGATAAC GGAGTTGTTGGTGTTTTGACCTTAGACAAC GGCGTTGTTGGTGTTTTGACCCTCGATAAT	3	1.0	TGTTGCGCTTTGTGACGAAATGGTTCGC TGTTGCTCTTTGCGACGAAATGGTGCTT TGTTGCTCTTTGCGATGAAATGGTGCTT	{13102} {13102} {13102}
5.7378437654486545	9776	9949	173	9776	2	1.0	TGGTGTTATGTATGGCGGTTTTGATGACCA TGGTGTTATGTATGGTGGTTTTGAAGACCA	9919	4	1.0	CTGTAGAACACTACAATGAATGGGCACAGA CTGTAGAACATTATAATGAGTGGGCACAGG CTGTGGAGCATTATAATGAGTGGGCACAGG CTGTTGAACACTATAATGAATGGGCACAGT	2	1.0	ACATGGTGGCTTAAAGGCGACAAATTGT ACCAGATGCTAACAGTTAATGTGGTCGC	{9891} {9832}
5.738232422683972	26634	26854	220	26634	4	1.0	TATGGCCATAGCCACACTTGTTATGTGGGT TATGGCCGTATCAACACTCATTATGTGGGT TATGGCCGTATCAACACTCGTTATATGGGT TATGGCTATAGCCACATTTGTTATGTGGGT	26824	2	1.0	GGCGTGCTTTACGTGGACGGACATAGATTG GGTGTTCTTTACGTGGACGGCCATAGAATC	1	1.0	CCGACGTGCTCGAACTTTTTGGGCATGG	{26694}
5.740229730317068	15171	15392	221	15171	5	1.0	GAAAGGTGTTTTATGCGCTTTTAGATTGGG GGAAAGTGTTTTATGCACTGTTAGACTGGG GGAAAGTGTTTTATGCACTTTTGGATTGGG GGAAGGTGTTCTATGCATTGTTAGACTGGG GGAAGGTGTTTTACGCATTGTTAGATTGGG	15362	1	1.0	TCTCAAACAGTTCTAAGATGCGGTGATTGT	1	1.0	CAAGAGTCCAAGTTTTGGGATGAAAGCT	{15269}
5.754428507007025	8526	8705	179	8526	2	1.0	GTTTGCGGTACAGGTCTGTGGGATCTTGTG GTTTGTGGTACTGGTTTGTGGAACCTTGTA	8675	4	1.0	TAGACGCATGTTTGGCGATCTTTCTGTAGG TAGACGCATGTTTGGTGACCTTTCTGTAGG TAGACGCATGTTTGGTGATTTGTCTGTAGG TAGACGTATGTTTGGTGATCTTTCTGTGGG	2	1.0	TTACTTAATTGTGCATTAGGTGCTTTCG TTTTCATGTTCATTTTCTGTAGCTGCAA	{8616} {8574}
5.754428507007025	11423	11602	179	11423	1	1.0	GGCTGAACAAGCTGCTGCAGCTATGTATAA	11572	5	1.0	ATGGTGTTGTACCCCTCTCTGTTATTCCTG ATGGTGTTGTCCCTCTCTCTGTTATTCCTG ATGGTGTTGTCCCTCTTTCCGTTATCCCTG ATGGTGTTGTTCCTCTTTCTGTTATCCCTG ATGGTGTTGTTCCTCTTTCTGTTATTCCTG	2	1.0	GTGTGGACACTATTCTTAACATGGCACG TCAAAAGTTGTTAGTGCAATGCATAGTT	{11542} {11478}
5.761416028494806	3116	3262	146	3116	3	1.0	ACATGAAGGTGACTGGGATAGCTTTTGTAA ACATGAGGGTGACTGGGATAGTTTTTGTAA ACATGAGGGTGATTGGGACAGTTTTTGTGA	3232	3	1.0	TGACTTTGCCTGTCATGATTTCTGAGTGGC TGAGTTTGCCCGTTATGTTTTCTGAATGGC TGAGTTTGCCTGTTATGATTTCTGAATGGC	3	1.0	AACTATTCAATCAGCACTGTCTGTAGTT AACTATTCAATCAGCACTTTCTGTTGTT GCTCTTGATGTAGTTTCTGGCTATGTGG	{3146} {3146} {3159}
5.772751599001681	1157	1343	186	1157	3	1.0	AACGCAGAAAGCAGGCGTTGGTATTAAGTA AACTCAGCAAGCTGGTGCTGGTATTAAGTA TACTCAGCAAGCTGGTGTTGGTGTTAAGTA	1313	3	1.0	CAGAATGGATACATTCTGCTTCAATGTACG TAGAATGGACACATTCTGCTTCAATGTACG TAGAATGGATACACTCTGCTTCAATGTGCG	2	1.0	CTTAAGTTTGTTGCAAACATTGAAGGTG GTCTGGCGAGTAATCGCTGTTCAAAGTG	{1203} {1236}
5.788219948987033	14586	14833	247	14586	4	1.0	GTGACGCGACTACTGCTTATGCTAACTCTG GTGATGCAACTACAGCCTACGCCAATTCTG GTGATGCAACTACAGCTTATGCTAATTCTG GTGATGCAACTACTGCTTATGCCAACTCTG	14803	2	1.0	GATGATCCTTTCTGATGACGGTGTTGTGTG GATGATTCTTTCTGATGATGGTGTTGTGTG	1	1.0	AGAAATAGTAATGTCGATGAGTCTTTTG	{14735}
5.8019141342961085	15664	15862	198	15664	4	1.0	CACATCTGATTGGTCTGATATCCGTGACTA TACCTCTGATTGGTCTGACATTCGCGACTA TACTTCAGACTGGTCTGACATACGTGACTA TACTTCTGATTGGTCTGACATTCGTGACTA	15832	2	1.0	ATGGGAAAGTGGAAAAGCCAAACCACCGTT ATGGGAAAGTGGAAAAGCCAAACCGCCATT	2	1.0	TTGTAGGTCCTAAGGAACTTTTGCTCTC TTGTAGGTCCTAAGGAATTTTTGCTCTC	{15804} {15804}
5.804228706359162	12910	13109	199	12910	3	1.0	GGACTTGTGCTTTGCTCTGCGTAACTTTGA GGATTTGTGCTTCGCTCTGCGTAACTTTGA GGATTTGTGTTTTGCCCTGCGTAATTTTGA	13079	3	1.0	GTCGCAAATGCAATGATTAAATGTGTGGCG GTCGCAAATGCAATGCTTAAGTGTGTTGCT GTTGCAAATGCAATGCTTAAGTGTGTGGCT	2	1.0	CTGATTACTTTGAAATGAAGAATTGGTT TTCTTACTGGTTGTTGTGGTACCGATTA	{12996} {12975}
5.806526686365171	16453	16653	200	16453	5	1.0	CGTAGATGAAGTGTCTATGTGCACCAATTA CGTAGATGAAGTGTCTATGTGCACTAACTA CGTGGATGAGGTGTCTATGTGCACTAACTA TGTAGATGAGGTGTCTATGTGCACCAACTA TGTGGATGAAGTGTCCATGTGCACTAACTA	16623	1	1.0	TGTGTGCTATAGGACCTGATGTCTTTTTAC	2	1.0	CCTAGGGTGCTTATATCCAAAGGAACTA GAGTTCTTATCTCTAAGGGTGTTATGGA	{16559} {16563}
5.828643513028184	1208	1343	135	1208	3	1.0	GTTCGTAGCTAGCATTGAGGGCGTTTCTGT GTTTGTTGCAAACATTGAAGGTGTCTCTGT GTTTGTTGCAAGCATTGAATGTGTCGCTGT	1313	3	1.0	CAGAATGGATACATTCTGCTTCAATGTACG TAGAATGGACACATTCTGCTTCAATGTACG TAGAATGGATACACTCTGCTTCAATGTGCG	4	1.0	GCTTTGTTGCTTCTTCCACTTTTGTAGA GGCGAGCAATTGCTGTTCAGAGTGTTGA TGGCGAGTAATCGCTGTTCAGAGTGTGG TGGCGAGTGATTGCTGTTCAAAGTGTAG	{1270} {1240} {1239} {1239}
5.828643513028184	25275	25485	210	25275	2	1.0	CAAGTGGCCGTGGTGGGTGTGGTTGTGCAT TAAGTGGCCATGGTGGGTGTGGTTGTGTAT	25455	4	1.0	ACAGTAATGGCTCTAGGTTTGTTCACATTG ACAGTAATGGCTCTAGGTTTGTTTACTCTG ACAGTAATGGCTTTAGGCTTGTTCACATTG TCAGTAATGGCTCTAGGCTTGTTCACACTT	2	1.0	AGGTTGTTGTGAGTCAACTAAACTTCCT GTCGCGCTCATCTTTGTGGTGAGTATGT	{25401} {25309}
5.8370799693424065	9800	10014	214	9800	3	1.0	AGACCAACCTAACCTTCAAGTTGAATCTGC GGACCAACCTAACCTTCAGGTTGAATCTGC TGACCAACCTAACCTTCAAGTTGAATCTGC	9984	3	1.0	TTCTCCATTCTTGCTGCTAAAACTGGCGTT TTTTCCATTCTTGCTGCTAAAACTGGTGTC TTTTCTATTCTTGCTGCAAAAACCGGTGTC	2	1.0	ACATGGTGGCTTAAAGGCGACAAATTGT ACCAGATGCTAACAGTTAATGTGGTCGC	{9891} {9832}
5.843219205502994	18603	18774	171	18603	3	1.0	CTGGCTTTAACATTTGGGTTCCTACCACGT CTGGTTTCAACATTTGGGTCCCTAACACAT CTGGTTTTAATATTTGGGTTCCTACCACGT	18744	3	1.0	TACCAGTAGCCATTAGTGGTGATAAAGTGT TACCAGTGGCTATTAGTGGTGATAAAGTGT TACCTGTGGCTATTAATGGCGACAAGGTGT	3	1.0	TACAGAGGTTAACCTGCAAGGTTTGGAA TGTGGCAAACATTTACAGAAGTAAATCT TGTTATAATTTGTGGCAGACATTCACAG	{18661} {18648} {18638}
5.848943765448655	5584	5757	173	5584	4	1.0	GTGACAAGGGTGATGCTGAAGACACTTTGA GTGCCAAAGGTGATGCTGAAGACACTTTGA GTGCTAAGGGTGATGCTGAAGATATTTTGA GTTCTAAGGGTGATGCTGAAGACACTTTGA	5727	2	1.0	ATAGTATGTGCTGGTGTTAAACGTGATGGT ATAGTTTGTGCTAGTGTCAAACGTGATGGT	3	1.0	AAGTTCAATTAGAACATTATAGTTCTTG AGTTGTCTAAGTATATCGCCAATGAGGC AGTTGTCTAAGTATCTTGCTAACGAAGC	{5647} {5617} {5617}
5.849332422683972	11423	11643	220	11423	1	1.0	GGCTGAACAAGCTGCTGCAGCTATGTATAA	11613	5	1.0	GCCAGGCTCGTCGTCGTAGTGCCAGATCAT TCCAAACTCGTCGTTGTAGTACCAGATCAT TCCAAGCTCGTCGTCGTGGTGCCAGATCAT TCCAAGCTTGTTGTTGTAGTACCAGATCAT TCCAAGCTTGTTGTTGTAGTGCCAGATTAT	2	1.0	GTGTGGACACTATTCTTAACATGGCACG TCAAAAGTTGTTAGTGCAATGCATAGTT	{11542} {11478}
5.851329730317068	8484	8705	221	8484	2	1.0	GACAAGTGGTTTGTTAATGATGGAAGTGTG GACAAGTGGTTTGTTAATGATGGACGTGTT	8675	4	1.0	TAGACGCATGTTTGGCGATCTTTCTGTAGG TAGACGCATGTTTGGTGACCTTTCTGTAGG TAGACGCATGTTTGGTGATTTGTCTGTAGG TAGACGTATGTTTGGTGATCTTTCTGTGGG	2	1.0	TAATGGTTATGTTTGCGGTACAGGTCTG TGGTTATGTTTGTGGTACTGGTTTGTGG	{8516} {8519}
5.857248055426138	11795	11937	142	11795	4	1.0	GACATGTGAACGTGTTGTTAAACTGCAGAA GACCTGCGAACGTGTTGTCAAATTGCAGAA GACTTGTGAACGCGTCGTTAAATTGCAGAA GACTTGTGAACGTGTTGTCAAATTGCAGAA	11907	2	1.0	CTATACAACAATGAAGGTGGACGTGCATTT TTATACAATAATGAGGGTGGCCGTGCATTT	4	1.0	TAATGCCAGGTAAAATGAAGGTCAAAGC TAATGCCAGGTAAGATGAAAGTCAAAGC TAATGCCGGGCAAGATGAAGGTTAAAGC TGAAGGTCAAGGCCACCAAAGGTGAAGG	{11833} {11833} {11833} {11848}
5.857343377117346	27096	27214	118	27096	4	1.0	TGGGCTGATGAGTCTGAGCAGCAGCGTGGT TGGGCTGATGCATCTGAACCACAACGTGGT TGGGCTGATGCTTCTGAACCACGGCGTGGT TGGGCTGATTCCTCTGAACCACAACGTGGT	27184	2	1.0	CTTGGAAAGTGATACCACGTGACTTGGTAC CTTGGAAGGTGATACCTCGTAATTTGGTAC	5	1.0	CGGGAAGAATTCCATATTCCTTGTACAG CGTCAGGCTAGAATCCCTTATTCTCTTT CGTCAGGGCAGAATACCTTATTCCCTTT CGTCAGGGTAGAATCCCTTATTCCGTTT GTTCAGGCAGAATCCCTTTTTCTCTTTA	{27130} {27126} {27126} {27126} {27127}
5.85919679600542	15740	15965	225	15740	4	1.0	GAAACGGTCAAGGCTAAAGAGGAAAGTGTT GAAACTGTCAAAGCTAAGGAGGAAAGTGTT GAAACTGTCAAGGCTAAAGAAGAAAGTGTG GAGACTGTGAAAGCTAAAGAGGAAAGCGTT	15935	2	1.0	GAGAAAGTAGATTATGGTTCTGATACGGTG GAGAAAGTGGATTATGGCTCTGACACGGTG	2	1.0	TTGTAGGTCCTAAGGAACTTTTGCTCTC TTGTAGGTCCTAAGGAATTTTTGCTCTC	{15804} {15804}
5.862823285568202	17572	17750	178	17572	3	1.0	AGTACCTCTGTTACGCAGGGGACAACCTTG AGTACCTCTGTTGCGTAAGGGCCAGCCGTG TGTACCTCTGTTACGCAAGGGACAACCTTG	17720	3	1.0	GTAAAGATAGGCTCTGTTAAGCATTGTCAG GTCAAGATTGGAGCTATTAAACACTGTCAG GTCAAGATTGGAGCTGTTAAACATTGCCAA	3	1.0	GAGTGTGTTGAGAAAACGTATTGTTCAA GAGTGTGTTGAGAAAGCGCATTGTCCAA GTTGCGTAAGCGCATTGTTCAGATGATA	{17602} {17602} {17608}
5.866875410741901	11671	11900	229	11671	3	1.0	GCTTTGTTCACTACGCAGGTGTTGTTTGGA GTTTTGTGCACTACGCTGGCGTTGTTTGGA GTTTTGTTCACTACGCGGGTGTTGTTTGGA	11870	3	1.0	TGAAAGCGATGGAGGTCTTAGCAGTGAAGG TGAAGGTGATGGAGGCATTACTAGTGAAGG TGAGGGTGATGGAGGTGTTACTAGTGAAGG	2	1.0	CAAGAGGTTAAAGACAATGATGGTAGGA TAAAGATGTTACAAAGGAAAACCAGGAA	{11706} {11744}
5.8798857056612075	26562	26710	148	26562	5	1.0	ACTCGCATTGTCTATTTTTGACACCTATGC ACTTGCACTTTCAATCTTTGACACTTGGGC ACTTGCTTTGTCAATCTTTGACACCTGGGC GCTTGCACTTTCTATTTTCGATTCTTGGGC GCTTGCTTTGTCAATTTTTGACACATACGC	26680	1	1.0	AGTTTCAGACTTTTCCGACGTGCTCGAACT	4	1.0	AACTGGGGATCCAACTGGGCCTTTGTTG ACTGGAATGAGAACTGGGCCTTTGTTGC ATTGGGACTCTAATTGGGCCTTTGTTGC GCATTCAGCCTTTTTATGGCCGTATCAA	{26593} {26594} {26594} {26620}
5.89063196905215	18532	18774	242	18532	3	1.0	TGGAGCAGTTTGTTCCAAACATGCTAACTT TGGTGCTGTATGTTCTAAGCATGCTAATCT TGGTGCTGTTTGTTCTAAACATGCAAACCT	18744	3	1.0	TACCAGTAGCCATTAGTGGTGATAAAGTGT TACCAGTGGCTATTAGTGGTGATAAAGTGT TACCTGTGGCTATTAATGGCGACAAGGTGT	2	1.0	AAACCTTTACTGAGGTTAATTTGCAAGG ACATTTGGGTTCCTACCACGTTTGATTG	{18654} {18612}
5.892388504066714	15619	15862	243	15619	4	1.0	TTCTGCGCTGGGTTCCATAGATGTTGATGT TTCTGCTGTGGGTTCCGTAGACGTAGATGT TTCTGCTTTGGGTTCCATAGACGTTGATGT TTCTGCTTTGGGTTCCATGGACATTGATGT	15832	2	1.0	ATGGGAAAGTGGAAAAGCCAAACCACCGTT ATGGGAAAGTGGAAAAGCCAAACCGCCATT	2	1.0	TTGTAGGTCCTAAGGAACTTTTGCTCTC TTGTAGGTCCTAAGGAATTTTTGCTCTC	{15804} {15804}
5.902730266661922	11438	11687	249	11438	3	1.0	TGCAGCTATGTACAAAGAAGCACGTGCTGT TGCAGCTATGTACAAGGAAGCACGTGCAGT TGCAGCTATGTATAAAGAAGCACGTGCAGT	11657	3	1.0	AATGATGGTAGATGGTTTTGTGCACTACGC AATGATGGTAGATGGTTTTGTTCACTACGC AATGTTGGTAGATGGTTTTGTGCACTATGC	2	1.0	GTGTGGACACTATTCTTAACATGGCACG TCAAAAGTTGTTAGTGCAATGCATAGTT	{11542} {11478}
5.919908310503012	11070	11271	201	11070	4	1.0	GAGTGGGCATATTGTGTTGAAACACACAAT GAGTGGGCATATTGTGTTGAAACGCACAAT GAGTGGGCGTATTGTGTTGAAACACATAAT GAGTGGGCGTATTGTGTTGAAATGCACAAC	11241	2	1.0	GTCGCATCATCTTTTGTTGGTATGCCGTCT GTTGCATCGTCTTTTGTTGGTATGCCATCT	3	1.0	TCTTGTCTAAGCATAGTGATTTAGGTCT TGTCTAAGCATAGTGATTTTGGTCTTGG TTTTGTCTAAGCATAGTGATTTTGGACT	{11164} {11167} {11164}
5.942553964378334	27185	27352	167	27185	2	1.0	TTGGAAAGTGATACCACGTGACTTGGTACC TTGGAAGGTGATACCTCGTAATTTGGTACC	27322	4	1.0	ACTACCTTGGAACAGGTCCCTACCCAGATG ACTATTTGGGCACAGGACCACATAAGGAAT ATTATCTTGGCACAGGACCCCATAAAGATG ATTATTTGGGCACAGGACCGCATCAAGATG	4	1.0	CAAAAACGTTTCAGAACTAGAAAGGGCA CAAGGGTGACAAAGACAAGTTTGTAGGT TCAGAACTAAGAAAGGTCAGAGAGTGGA TCAGAACTCGTAAAGGGCAGCGTGTTGA	{27261} {27221} {27271} {27271}
5.946091578646308	26122	26335	213	26122	4	1.0	GATGTTCCTGAAATTAGTGGATGATCATGC GATGTTCCTGAAGCTAGTTGATGATCACGC GATGTTCCTTAAGCTAGTGGATGATCATGC GATGTTTCTGAAGCTAGTGGATGATCATGC	26305	2	1.0	CCAATCATACATGCACATAGACCCTTTCCC CCAGTCTTATATGCACATAGACCCTTTTCC	3	1.0	ATATGTTTTGTAATAGAACAGTTTATGG GGCCCAATTAAAAATGTATATCACATTT TGCCATATGTTCTGTTCTAGAACAGTTT	{26250} {26276} {26246}
5.95436473040372	9129	9346	217	9129	3	1.0	GCAGATTACCGCTGTGCTTGTTATGCTTAT GCAGATTACCGTTGTGCTTGTTATGCCTAT GCTGATTACCGTTGTGCTTGTTATGCTTAT	9316	3	1.0	ACACTGTGTTAAATGGTTTATGGCTTGGTG ACACTGTGTTGAATGGGTTGTGGCTTGGTG ACACTGTGTTGAATGGTTTGTGGCTTGGAG	3	1.0	ATACACACCTCCAACTGTCAGTTATGGG GCAAAAGCAATGCTGGACTTTTCGCGTG TGGACTATTCGCGTGATCATAATGACAT	{9206} {9162} {9175}
5.957194263681199	5197	5369	172	5197	3	1.0	CAGACAAGTCATTTGAACAACAAGTTGGTG CGGACAAACCATTTGAGCAGCAGGTTGGCG CGGATAAGTCGTTTGAGCAACAAGTTGGTG	5339	3	1.0	AGACGCCACTACATTTGCAACATTAGATCA AGACGCTGTTACTTTTGCAACAGTTGATCA AGATGCTGTAACCTTTGCAACAGTTGATCA	4	1.0	ACAAAGATCTTTCTGGTGCAGTACCAAG GTGATCTTAATACGTCAGAATTGCTTAC GTTAAAGACAAAGATCTTTCTGGTTCAG TTGCGGACAAGGATGTGGACCTTTCTGG	{5242} {5269} {5235} {5230}
5.962429730317068	9056	9277	221	9056	2	1.0	CTCTCCAGAAAAGTTGAAAAGTTATGCTGC TTCGCCAGATAAGTTGAAAAGTTATGCAGC	9247	4	1.0	CAGGTTTGCGTAAAATGGCACAGCCATCTG CAGGTTTGCGTAAAATGGCGCAGCCGTCTG CTGGCCTGCGTAAAATGGCACAACCATCTG CTGGTTTGCGCAAAATGGCACAACCATCTG	3	1.0	ATACACACCTCCAACTGTCAGTTATGGG CTTATTTAGCAAAAGCAATGTTGGACTT TGGACTATTCGCGTGATCATAATGACAT	{9206} {9154} {9175}
5.968543377117347	9592	9681	89	9592	4	1.0	GCTATGATGGTTGTGCCCAAGGTGTCTTTG GCTATGATGGTTGTGCTCAGGGTGTTTTTG GTTATGATGGTTGTGCACATGGTGTTTTTG GTTATGATGGTTGTGCCCAAGGTGTTTTCG	9651	3	1.0	CGAGGTTCATTTATTAATGGTGCATGTGGT CGTGGTTCATTCATTAATGGTGCATGTGGC CGTGGTTCATTTATTAATGGTGCGTGTGGT	2	1.0	GTGTGAACATGAGAACTAACTGGACTAT GTGTGAACATGAGGACCAATTGGACTAT	{9622} {9622}
5.979311090344212	9166	9346	180	9166	3	1.0	AAGCAATGCTGGATTTTTCGCGTGATCATA AAGCAATGTTGGACTTTTCGCGTGATCATA AGGCCATGATGGACTATTCGCGTGATCATA	9316	3	1.0	ACACTGTGTTAAATGGTTTATGGCTTGGTG ACACTGTGTTGAATGGGTTGTGGCTTGGTG ACACTGTGTTGAATGGTTTGTGGCTTGGAG	4	1.0	ATACACACCTCCAACTGTCAGTTATGGG CGGTTCTACATTACAGGCAGGTTTGCGT GGTTCGACCTTGCAAGCAGGTTTGCGTA TCAGTTACGGTTCTACATTACAGGCAGG	{9206} {9230} {9231} {9223}
5.984609836406473	18930	19112	182	18930	4	1.0	TATTGTGGGATTATGAAGCTGACCGGCCCT TCCTGTGGGATTATGAAGCTGAACGTCCTT TCTTGTGGGATTATGAAGCTGAGCGTCCCT TGTTATGGGATTATGAAGCAGAACGTCCTC	19082	2	1.0	TTCTCTGCTACTGCTGTGAAAGCAGGTGGT TTCTCTGTTACTGCTGTTAAAACAGGTGGT	4	1.0	ACAAGTTTTACTAAGTCTGTTTGTGGTT AGGTTCTTATGAACGTTTTACTCTGTCA TAACTAGTTTCACTAAGTCTGTCTGTGG TTACAAGCTTTACTAAGGCTGTTTGTGG	{18962} {19039} {18960} {18960}
5.989159109049143	8163	8398	235	8163	3	1.0	GCCTTTGGTAGTGCAGGTGTCTGTTATGAC GCGTTTGGTAATGCTGGTGTGTGTTATGAC GCTTTTGGTAATGCTGGTGTTTGTTATGAC	8368	3	1.0	AATTGCCAGAAGTAATTGCACAGGGTTTTG AATTGCCGGAAATAATTGCACAGGGCTTTG AGTTGCCAGAAGTTATTGCACAAGGCTTTG	3	1.0	TATTTGGAGTTACTACACCTGAAAAGTG TGGAGTCACAACACCGGAAAAGTGCATC TTGGCGTCACAACACCTGAAAAGTGCAT	{8194} {8198} {8197}
5.989159109049143	9360	9595	235	9360	2	1.0	CCACGGCACGTTATCGCATCTAATACAACT CCACGTCATGTTATTGCATCTAACACAACT	9565	4	1.0	CTGGCGAAGGTTTTAACATCTTAGCTTGTT CTGGTGAAGGATTTAACATTCTGGCGTGTT CTGGTGAAGGTTTTAACATCCTAGCTTGCT CTGGTGAAGGTTTTAACATCTTAGCATGCT	3	1.0	ATAACATCTGGTACAGCATTTCTTGGTG GCATGGAGCAACTCTTAAAATTAAAGTT TAACTTTTCTATAACATCAGGCTCTGTG	{9444} {9488} {9434}
6.079548055426138	16723	16824	101	16723	3	1.0	ACCAGTCAAAGATGCCAGTAAGCAGTGCTT ACCCGTCAAAGAGGCTAGTAAGCAGTGCTT ACCTGTCAAAGAAGCTAGTAAGCAGTGCTT	16794	4	1.0	CCAGTATAAACAGGCGCCAACTTGATGTTG CCAGTATAAACCGTCGACAACTTGACGTCG CCAGTATAAATAGACGCCAACTTGATGTTG CCAGTATAAATAGGCGTCAACTTGATGTTG	2	1.0	AAAATCTTTGAACGCGGTAGTGTTCAGG AAAATCTTTGAACGTGGTAGTGTGCAGG	{16754} {16754}
6.094716028494806	27185	27417	232	27185	2	1.0	TTGGAAAGTGATACCACGTGACTTGGTACC TTGGAAGGTGATACCTCGTAATTTGGTACC	27387	4	1.0	ATCTGGGTCGCTATTGATGGTGCCAAAACC GTCTGGGTTGCAGTTAATGGTGCTAAAACA GTCTGGGTTGCTGTTGATGGTGCTAAAACC GTTTGGGTTGCCATGAATGGTGCCAAAACT	4	1.0	CAAAAACGTTTCAGAACTAGAAAGGGCA CAAGGGTGACAAAGACAAGTTTGTAGGT TCAGAACTAAGAAAGGTCAGAGAGTGGA TCAGAACTCGTAAAGGGCAGCGTGTTGA	{27261} {27221} {27271} {27271}
6.1353141342961095	11898	12027	129	11898	3	1.0	GGCAATGCCTTATACAATAATGAGGGTGGC GGTAACGCTCTATACAATAATGAAGGTGGA GGTAATGCTCTATACAACAATGAAGGTGGA	11997	4	1.0	GGCGTGGTTACAGTAGAACTAGAACCACCT GGTGTGGTTACAGTTGAATTGGAACCACCT GGTGTGGTTGCAGTGGAATTGGAACCACCT GGTGTTGTTACAGTAGAGTTAGAACCTCCA	1	1.0	CGTGCATTTATGTATGCATATGTGACTA	{11928}
6.157740537842753	26638	26772	134	26638	5	1.0	GCCATAGCCACACTTATTATGTGGGTTATG GCCGTATCAACACTCATTATGTGGGTGATG GCCGTATCAACACTCGTTATATGGGTGATG GCCGTATCAACACTCGTTATGTGGGTTATG GCTATAGCCACATTTGTTATGTGGGTTATG	26742	2	1.0	CACAGTCACAACCGTGCTGGGACAGACGTA CACTGTCACAACCGTGTTGGGACAGACATA	1	1.0	CCGACGTGCTCGAACTTTTTGGGCATGG	{26694}
6.174616373031192	9800	9899	99	9800	3	1.0	AGACCAACCTAACCTTCAAGTTGAATCTGC GGACCAACCTAACCTTCAGGTTGAATCTGC TGACCAACCTAACCTTCAAGTTGAATCTGC	9869	4	1.0	TGCGGCTATATTGAATGGTTGCACCTGGTG TGCTGCCATACTGAATGGTTGTACATGGTG TGCTGCTATATTGAATGGTTGCACATGGTG TGCTGCTATATTGAATGGTTGCATATGGTG	3	1.0	AACCAGATGCTAACAGTCAATGTGGTAG ACCAGATGCTAACAGTTAATGTGGTCGC AGTCAAATGTTAACGACTAATGTTGTAG	{9831} {9832} {9831}
6.190648055426139	9881	9982	101	9881	4	1.0	GAATGGTTGCACATGGTGGCTCAAAGGTGA GAATGGTTGCACATGGTGGCTTAAAGGTGA GAATGGTTGCACCTGGTGGCTTAAAGGCGA GAATGGTTGCATATGGTGGCTCAAAGGTGA	9952	3	1.0	ATGGTTTCACAGCTATGAATGGTGAAGACG ATGGTTTTACAGCCATGAATGGTGAAGATG ATGGTTTTACAGCTATGAATGGCGAAGATG	3	1.0	TAGAACATTACAATGAATGGGCACAGAC TAGAACATTATAATGAGTGGGCACAGGC TAGGTTGTCTGTTGAACACTATAATGAA	{9922} {9922} {9911}
6.190743377117347	324	442	118	324	4	1.0	GCAAGTGATACTGAAATTTCTGCAACTGGC GCAAGTGATACTGAAATTTCTGCAACTGGT GCAAGTGATTCTGAAATTTCTGCATATGGC GCAAGTGATTCTGAAATTTCTGGAACTGGC	412	3	1.0	GAACATGCCGATTTGTCTCATTTGGTTTGC GAGCATGCCGATTTGTTTCATTTGGCTTGC GGGCATGCCGATTTGTTTCATTAGATTTGC	2	1.0	CCACCGTTGCTCAAGCCGTCCGCCTTTA GCGCTAGCCGTCCGCCGCTATAGCGAGG	{358} {366}
6.206909836406473	11566	11687	121	11566	4	1.0	CACGTAATGGTGTTGTACCCCTCTCTGTTA CACGTAATGGTGTTGTCCCTCTCTCTGTTA CACGTAATGGTGTTGTCCCTCTTTCCGTTA CACGTAATGGTGTTGTTCCTCTTTCTGTTA	11657	3	1.0	AATGATGGTAGATGGTTTTGTGCACTACGC AATGATGGTAGATGGTTTTGTTCACTACGC AATGTTGGTAGATGGTTTTGTGCACTATGC	2	1.0	GTCGTCGTGGTGCCAGATCATGATTCAT GTCGTTGTAGTACCAGATCATGATTCAT	{11622} {11622}
6.2223	8484	8608	124	8484	2	1.0	GACAAGTGGTTTGTTAATGATGGAAGTGTG GACAAGTGGTTTGTTAATGATGGACGTGTT	8578	5	1.0	CATCCTCATTTTCTGTTGCCGCAATGTCAG CATCTTCATTTTCTGTTGCTGCAATGTCAG CATGTTCATTTTCTGTAGCTGCAATGTCAG CATTATCGTTCTCTGTAGCCGCAATGTCAG CGTCCTCATTCTCTATTGCTGCAATGTCAG	2	1.0	TAATGGTTATGTTTGCGGTACAGGTCTG TGGTTATGTTTGTGGTACTGGTTTGTGG	{8516} {8519}
6.2477885273624	25275	25384	109	25275	2	1.0	CAAGTGGCCGTGGTGGGTGTGGTTGTGCAT TAAGTGGCCATGGTGGGTGTGGTTGTGTAT	25354	5	1.0	GCCACAGGTTGTTGTGGCTGCTGTAGTTGT GCTACAGGTTGTTGTGGCTGTTGTAGTTGT TCCACTGGTTGTTGCGGCTTCTTTAGTTGT TCTACTGGTTGCTGCGGTTTCTTTAGTTGT TCTACTGGTTGCTGTGGCTTCTTTAGTTGT	3	1.0	GTCCTAATTTTTACTGTGGGCTTGCTCT GTCGTGCTCATCTTTGTGGTGAGTATGT TGTGATTGTGTTGATTTTTGTGGTGGGC	{25312} {25309} {25305}
6.251026686365171	8517	8612	95	8517	2	1.0	AATGGTTATGTTTGCGGTACAGGTCTGTGG AATGGTTATGTTTGTGGTACTGGTTTGTGG	8582	5	1.0	ATCGTTCTCTGTAGCCGCAATGTCAGGTCA CTCATTCTCTATTGCTGCAATGTCAGGCCA CTCATTTTCTGTTGCTGCAATGTCAGGTCA TTCATTCTCTGTTGCTGCAATGTCAGGTCA TTCATTTTCTGTTGCTGCAATGTCAGGCCA	4	1.0	AACCTTGTATTTAACATATTTTCCATGT ACCTTATACTCAATGTGTTTTCCATGTT TGTATTTAACATACTCTCCATGTTTTCG TGTTTAACATACTATCCATGTTTTCATG	{8547} {8548} {8552} {8554}
6.260612910986066	8163	8274	111	8163	3	1.0	GCCTTTGGTAGTGCAGGTGTCTGTTATGAC GCGTTTGGTAATGCTGGTGTGTGTTATGAC GCTTTTGGTAATGCTGGTGTTTGTTATGAC	8244	4	1.0	AGATTAGAAGGTCTGGGTGGTAACAATGTC AGATTAGAGGGTCTTGGTGGTAACAATGTT AGATTGGAAGGTTTGGGTGGTAACAATGTT AGGCTAGAAGGTTTGGGTGGTGATAATGTT	3	1.0	TATTTGGAGTTACTACACCTGAAAAGTG TGGAGTCACAACACCGGAAAAGTGCATC TTGGCGTCACAACACCTGAAAAGTGCAT	{8194} {8198} {8197}
6.2688405378427525	9881	10015	134	9881	4	1.0	GAATGGTTGCACATGGTGGCTCAAAGGTGA GAATGGTTGCACATGGTGGCTTAAAGGTGA GAATGGTTGCACCTGGTGGCTTAAAGGCGA GAATGGTTGCATATGGTGGCTCAAAGGTGA	9985	3	1.0	TCTCCATTCTTGCTGCTAAAACTGGCGTTT TTTCCATTCTTGCTGCTAAAACTGGTGTCT TTTCTATTCTTGCTGCAAAAACCGGTGTCT	2	1.0	TAGAACATTATAATGAGTGGGCACAGGC TTTACAGCTATGAATGGCGAAGATGCGT	{9922} {9957}
6.2818905569654335	15171	15340	169	15171	5	1.0	GAAAGGTGTTTTATGCGCTTTTAGATTGGG GGAAAGTGTTTTATGCACTGTTAGACTGGG GGAAAGTGTTTTATGCACTTTTGGATTGGG GGAAGGTGTTCTATGCATTGTTAGACTGGG GGAAGGTGTTTTACGCATTGTTAGATTGGG	15310	2	1.0	GTATGAAAAGTCTACAGTTCTTCAAGCAGC GTATGAGAAGTCTACAGTACTACAAGCTGC	1	1.0	CAAGAGTCCAAGTTTTGGGATGAAAGCT	{15269}
6.296268161147406	1208	1382	174	1208	3	1.0	GTTCGTAGCTAGCATTGAGGGCGTTTCTGT GTTTGTTGCAAACATTGAAGGTGTCTCTGT GTTTGTTGCAAGCATTGAATGTGTCGCTGT	1352	4	1.0	AACTGATGAGTGTCGATTGGCCATGTTAGG TACTGATGAGTGTCGTATAGCTATGTTAGG TACTGATGAGTGTCGTTTGGCCATGTTGGG TGTTGATGAGTGTCGTATGGCCATGTTGGG	1	1.0	CAGAATGGATACATTCTGCTTCAATGTA	{1313}
6.313266666009797	16530	16675	145	16530	5	1.0	ATGTTGGCGACCCTCAACAGCTTCCAGCCC ATGTTGGTGACCCTCAACAATTGCCAGCTC ATGTTGGTGACCCTCAACAGTTGCCTGCTC ATGTTGGTGATCCTCAACAGCTGCCAGCTC ATGTTGGTGATCCTCAACAGCTTCCAGCTC	16645	2	1.0	CTTTTTACACAAATGTTACAGGTGTCCAGC CTTTTTACACAAGTGTTACAGATGTCCTGC	2	1.0	AGGGTGCTTATATCCAAAGGAACTATGG GAGTTCTTATCTCTAAGGGTGTTATGGA	{16562} {16563}
6.3334	9129	9253	124	9129	3	1.0	GCAGATTACCGCTGTGCTTGTTATGCTTAT GCAGATTACCGTTGTGCTTGTTATGCCTAT GCTGATTACCGTTGTGCTTGTTATGCTTAT	9223	4	1.0	TCAGTTATGGGTCTACATTACAAGCAGGTT TCAGTTATGGTTCTACATTACAGGCAGGTT TCAGTTATGGTTCTACATTACAGGCTGGCC TTAGTTATGGTTCGACCTTGCAAGCAGGTT	3	1.0	GCAAAAGCAATGCTGGACTTTTCGCGTG GCGAAAGCAATGTTGGACTTTTCGCGTG TGGACTATTCGCGTGATCATAATGACAT	{9162} {9162} {9175}
6.343264373321449	1319	1445	126	1319	4	1.0	GGACACATTCTGTTTCAATGTACGCAATAG GGATACACTCTGCTTCAATGTGCGTAATGC GGATACATTCTGCTTCAATGTACGCAATAG GGATACATTCTGCTTCAATGTGCGTAATAG	1415	3	1.0	TGCTACAGGTGTTATTGATATTAGTGCAGG TGCTGCAGGTGTCATAGACATTAGTACCGG TGCTGCAGGTGTCATTGACATTAGCACCGG	3	1.0	ATGTTAGGTGCTGAATTGACTAGTAATG GATGAGTGTCGTTTGGCCATGTTGGGTG TACTGTTGATGAGTGTCGTATGGCCATG	{1374} {1356} {1349}
6.343264373321449	5342	5468	126	5342	3	1.0	CGCCACTACATTTGCAACATTAGATCATAG CGCTGTTACTTTTGCAACAGTTGATCATAG TGCTGTAACCTTTGCAACAGTTGATCATAG	5438	4	1.0	TTGGGTGAATGCTGTGTGTATTTCACTACA TTGGGTGAATGCTGTTTGTATTGCACTACA TTGGGTTAATGCTGTGTGCGTTGCATTACA TTGGGTTAATGCTGTTTGTATCTCACTGCA	3	1.0	AGTACTGTTGTTAATGGTGTCAGAGTCT GAGTGTTGAAAACCAGTAATAATAATTG TGCGTTTGCATATGAAAGTAGTGTTGTT	{5388} {5410} {5372}
6.352834243325826	383	511	128	383	3	1.0	CTATAGCGAGGCCGCTAGCAATGGATTTAG TTATAGCGAGGCCGCTAGCAATGGTTTTAG TTATAGCGAGGCCGCTGTCAATGGTTTTAG	481	4	1.0	TGGGTCTGACCGGCGACCAACCACTGGTTT TGGGTCTGCATGGCAATCAGACGTTGTTTT TGGGTCTGCATGGTAACCAAACGTTGTTCT TGGGTTTGCATGGTAACCAAACGTTGTCCT	3	1.0	AGCATGCCGATTTGTCTCATTTGGTTTG GCATGCCGATTTGTTTCATTTGGTTTGC GGCATGCCGATTTGTTTCATTAGATTTG	{413} {414} {413}
6.377937705370951	19084	19248	164	19084	2	1.0	CTCTGCTACTGCTGTGAAAGCAGGTGGTAA CTCTGTTACTGCTGTTAAAACAGGTGGTAA	19218	5	1.0	ACGTACGCAAAGATGGTAAACATGTTGATC ACGTTCGCAAGGATGGCAAGCTTTTGGACC ATGTACGCAAAGATGGCAAACCTGTGGATC ATGTACGCAAAGATGGTAAGCCTGTTGATC ATGTACGCAGAGATGGCAAGCCTGTAGATC	2	1.0	ATTTGCCAGCCATTCGGTTAAATTTTGG TTGCCGGCTATTAAATTGAATTTTGGAA	{19116} {19118}
6.3926799693424075	9667	9804	137	9667	5	1.0	ATGGTGCATGTGGCTCTCCTGGTTACAATC ATGGTGCATGTGGTTCCCCTGGCTATAATC ATGGTGCATGTGGTTCTCCTGGCTATAATC ATGGTGCGTGTGGTTCCCCTGGCTATAACC ATGGTGCGTGTGGTTCTCCTGGCTACAATC	9774	2	1.0	GATGGTGTTATGTATGGCGGTTTTGATGAC GATGGTGTTATGTATGGTGGTTTTGAAGAC	3	1.0	GCATCAAATTGAACTCGGAAGTGGTAGT TGGCGAGGTGGAATTTGTTTATATGCAT TTAGAGGTAGCGAGGTTGAGTTTTGTTA	{9728} {9704} {9697}
6.4016942636811995	16663	16835	172	16663	3	1.0	CAGATGTCCTGCTGAAATAGTTAACACTGT CAGGTGTCCAGCTGAAATAGTTAACACTGT CAGGTGTCCTGCTGAAATAGTTAATACTGT	16805	4	1.0	AGACGCCAACTTGATGTTGTTAAGCGATTT AGGCGCCAACTCGATGTTGTCAAGCGATTT AGGCGTCAACTTGATGTTGTTAAGCGATTT CGTCGACAACTTGACGTCGTCAAGCGTTTT	2	1.0	CCAGTCAAAGAGGCCAGTAAGCAGTGCT GTTTGTACCTGTCAAAGAAGCTAGTAAG	{16724} {16717}
6.410887395870146	6466	6689	223	6466	4	1.0	GCGGTAATTCATTGGGCTGTAAGATGTGTC GTGAAGGTTCACTAGGTTGTAAAATGTGTC GTGATGGTTCATTGGGCTGCAAGATGTGTC GTGATGGTTCATTGGGCTGTAAAATGTGTC	6659	3	1.0	GATGATAAGCAATGTAGGCGTTTTCTTGGG GATGATAAGCACAGTTGGTGTTTTTCTAGG GATGATAAGCACTGTTGGTGTTTTTCTGGG	1	1.0	ACAATTATCTGAGATGCTTCTTGCTGTA	{6619}
6.414796796005421	1157	1382	225	1157	3	1.0	AACGCAGAAAGCAGGCGTTGGTATTAAGTA AACTCAGCAAGCTGGTGCTGGTATTAAGTA TACTCAGCAAGCTGGTGTTGGTGTTAAGTA	1352	4	1.0	AACTGATGAGTGTCGATTGGCCATGTTAGG TACTGATGAGTGTCGTATAGCTATGTTAGG TACTGATGAGTGTCGTTTGGCCATGTTGGG TGTTGATGAGTGTCGTATGGCCATGTTGGG	1	1.0	CAGAATGGATACATTCTGCTTCAATGTA	{1313}
6.446231969052151	5797	6039	242	5797	4	1.0	CACGAGTCAGGAGTGTTAGTGGGCGTGCCA CACGTGTTAAAAGTGTTAGAGGTAGAGCTA CACGTGTTAAGAGTGTCAGTGGTAGAGCCA CACGTGTTAGAAGTGTTAGCGGTAGAGCTA	6009	3	1.0	TCAGTTGTTATGGTAGGGGGTTATGTGGCT TCAGTTGTTATGGTGGGAGGCTATGTCGCA TCAGTTGTTATGGTTGGTGGTTATGTTGCA	1	1.0	GGTGTTGCTTACACTGCTTTTTCTGGAC	{5880}
6.451926590941621	17993	18184	191	17993	3	1.0	GACTGGTCAATAACCTACCCTATGATAGCT GACTGGTCAATTACCTATCCTATGATAGCT GATTGGTCAATTACCTACCCTATGATAGCT	18154	4	1.0	TGCAAAGTGGTATTGTTACGACAAGGACCC TGCCAAATGGTATTGTTACGACAAGGATCC TGCCAAGTGGTACTGTTATGACAAAGACCC TGCCAAGTGGTATTGTTATGACAAGAACCC	2	1.0	CGTGTGGTACAGAGTCATATTATGCGCG TGCAAAGTCATATCATGCGTGCTGCTAT	{18050} {18057}
6.453201087828205	8245	8398	153	8245	4	1.0	GATTAGAAGGTCTGGGTGGTAACAATGTTT GATTAGAGGGTCTTGGTGGTAACAATGTTT GATTGGAAGGTTTGGGTGGTAACAATGTTT GGCTAGAAGGTTTGGGTGGTGATAATGTTT	8368	3	1.0	AATTGCCAGAAGTAATTGCACAGGGTTTTG AATTGCCGGAAATAATTGCACAGGGCTTTG AGTTGCCAGAAGTTATTGCACAAGGCTTTG	3	1.0	ACAACACAGCTCTCATGGAAGGTTCATT GGAAGGCTCTTTGCCTTACAGTTCACTA TATAGTTCAATACAAGCTAACGCATATT	{8281} {8297} {8313}
6.454364373321448	7410	7602	192	7410	5	1.0	CTCGCTGAATGTAAAAATGCATTGAGCTTG CTTGCTGATTGTAAGAGTGTGTTAGGTTTG TTAGCCGAGTGCAAGAGTGCTTTAGGCTTG TTAGCCGAGTGTAAGAGTGCTTTAGGCTTG TTAGCCGATTGCAAGAGTGCTTTAGGCCTG	7572	2	1.0	TTAGCTTGTTGTATGCGCGCTGGTGCTAAG TTGGCTTGTTGTATGCGTGCAGGTGCTAAG	2	1.0	ACACCGTTATGATGTGTTGTTATCAGAT CACATCGTTGTGACGTGTTGTTATCTGA	{7481} {7480}
6.456629642842771	9129	9283	154	9129	3	1.0	GCAGATTACCGCTGTGCTTGTTATGCTTAT GCAGATTACCGTTGTGCTTGTTATGCCTAT GCTGATTACCGTTGTGCTTGTTATGCTTAT	9253	4	1.0	TGCGCAAAATGGCACAACCATCTGGCTTTG TGCGTAAAATGGCACAACCATCTGGCATTG TGCGTAAAATGGCACAGCCATCTGGCATTG TGCGTAAAATGGCGCAGCCGTCTGGCATTG	3	1.0	ATACACACCTCCAACTGTCAGTTATGGG GCAAAAGCAATGCTGGACTTTTCGCGTG TGGACTATTCGCGTGATCATAATGACAT	{9206} {9162} {9175}
6.456783757168364	318	511	193	318	3	1.0	GCCGTAGCAAGTGATACTGAAATTTCTGCA GCCGTTGCAAGTGATTCTGAAATTTCTGGA GCTGTTGCAAGTGATACTGAAATTTCTGCA	481	4	1.0	TGGGTCTGACCGGCGACCAACCACTGGTTT TGGGTCTGCATGGCAATCAGACGTTGTTTT TGGGTCTGCATGGTAACCAAACGTTGTTCT TGGGTTTGCATGGTAACCAAACGTTGTCCT	2	1.0	CCACCGTTGCTCAAGCCGTCCGCCTTTA GCGCTAGCCGTCCGCCGCTATAGCGAGG	{358} {366}
6.460021916171137	11777	12027	250	11777	3	1.0	TGTCTGGCCTCTGATTTTGACCTGCGAACG TGTTTGGCCTCTGATTTTGACTTGTGAACG TGTTTGGCCTTTGGTTTTGACATGTGAACG	11997	4	1.0	GGCGTGGTTACAGTAGAACTAGAACCACCT GGTGTGGTTACAGTTGAATTGGAACCACCT GGTGTGGTTGCAGTGGAATTGGAACCACCT GGTGTTGTTACAGTAGAGTTAGAACCTCCA	1	1.0	GGACGTGCATTTATGTATGCATATGTGA	{11925}
6.46670063353398	11114	11271	157	11114	5	1.0	TGACGACCCTGAAACTGCTCAAGAGTTATT TGACGACCCTGAGACGGCGCAGGAGCTTTT TGACGACCCTGAGTTAGCCCAAGAGCTGCT TGATAACCCCGAAACTGCTCAGGAGCTGTT TGATGACCCTGAAACTGCTCAAGAATTGTT	11241	2	1.0	GTCGCATCATCTTTTGTTGGTATGCCGTCT GTTGCATCGTCTTTTGTTGGTATGCCATCT	3	1.0	TCTTGTCTAAGCATAGTGATTTAGGTCT TGTCTAAGCATAGTGATTTTGGTCTTGG TTTTGTCTAAGCATAGTGATTTTGGACT	{11164} {11167} {11164}
6.468614134296109	6659	6857	198	6659	3	1.0	GATGATAAGCAATGTAGGCGTTTTCTTGGG GATGATAAGCACAGTTGGTGTTTTTCTAGG GATGATAAGCACTGTTGGTGTTTTTCTGGG	6827	4	1.0	TGCATGTTCTAAGAGTGCTAGACTTAAGAG TGCGTGCTCTAAGAGTGCTAGACTTAAGAG TGCTTGCTCAAAGAGTGCAAGATTGAAGCG TGCTTGTTCTAAAAGTGCAAGACTTAAGCG	2	1.0	GAAACTAATTGGTTTTTGCATTTTATAC TCCATTTGATGTTATTTGTGATGAACTA	{6696} {6722}
6.480023411032158	9478	9681	203	9478	4	1.0	GTGCTACTATGCATGGAGCAACTCTTAAAA GTGCTACTATGCATGGCTCAACTCTTAAAA GTGCTACTATGCATGGGGCAACTCTTAAAA GTGCTACTATGCATGGTGCAACTCTTAGAA	9651	3	1.0	CGAGGTTCATTTATTAATGGTGCATGTGGT CGTGGTTCATTCATTAATGGTGCATGTGGC CGTGGTTCATTTATTAATGGTGCGTGTGGT	2	1.0	ACAGACTAACATGTGCACTCCGAAGCAT ATGATGGTTGTGCCCAAGGTGTTTTCGG	{9518} {9595}
6.501691578646308	12853	13066	213	12853	4	1.0	AGGCAGAACCATCTATGGTAACGTTAGTAG AGGCCGAACCATCTATGGTAATGTTAGTAG GGGCAGAACCATCTATGGTAATGTTAGTAG GGGCAGAACCATTTATGGTAATGTTAGTAG	13036	3	1.0	AAATGAGGACATACACCGCGTGTACGCTGC AAATGAGGACATACACCGTGTATACGCTGC AAATGAGGACATACACCGTGTGTATGCTGC	2	1.0	CTGATTACTTTGAAATGAAGAATTGGTT TTCTTACTGGTTGTTGTGGTACCGATTA	{12996} {12975}
6.514022592664184	865	1084	219	865	4	1.0	GTTCTGTTCTCGAAACGGCGAAGGAAGTGA GTTCTGTTCTTGAAACGGCTAAGGATTTGA GTTCTGTTCTTGAAATGGCTAAGGAAGTGA GTTCTGTTCTTGATATAGCTAAGGAGGCCA	1054	3	1.0	CTGTCGGTGATTGGACTGGTTTTAAATCCA CTGTGGGTGATTGGACCGGTTTTAAATCCT CTGTTGGTGATTGGACCGGATTTAAATCCT	2	1.0	CTTGACAAACTTTACAAAGTTTTTGGTT GTTAAGTGATGAACTTGACAAACTTTAC	{927} {914}
6.515643765448655	13063	13236	173	13063	4	1.0	TGCTTTAGGCAAGGTAGTTGCAAATGCAAT TGCTTTGGGTAAAGTAGTCGCAAATGCAAT TGCTTTGGGTAAGGTAGTCGCAAACGCAAT TGCTTTGGGTACAGTAGTCGCAAATGCAAT	13206	3	1.0	TGTGTCCGCCTGGAATGGGAATACCTTATT TGTGTCCTCCTGGAATGGGAATACCCTACT TGTGTCCTCCTGGTATGGGAATACCCTATT	3	1.0	TGTTGCGCTTTGTGACGAAATGGTTCGC TGTTGCTCTTTGCGACGAAATGGTGCTT TGTTGCTCTTTGCGATGAAATGGTGCTT	{13102} {13102} {13102}
6.5180297303170684	11167	11388	221	11167	3	1.0	TGTCTAAGCATAGTGATTTTGGACTCGGTG TGTCTAAGCATAGTGATTTTGGTCTTGGCG TGTCTAAGCATAGTGATTTTGGTCTTGGTG	11358	4	1.0	GCAATGAATGTTGCTAAGGCTGAGTTTGAC GCCATGAATGTTGCCAAGGCTGAGTTTGAT GCTATGAATGTTGCAAAAGCTGAGTTTGAC GCTATGAATGTTGCTAAAGCCGAATTTGAC	2	1.0	GCATCATCTTTTGTTGGTATGCCGTCTT TCGTCTTTTGTTGGTATGCCATCTTTTG	{11244} {11247}
6.527833761645287	8678	8904	226	8678	4	1.0	ACGCATGTTTGGCGATCTTTCTGTAGGTGT ACGCATGTTTGGTGACCTTTCTGTAGGTGT ACGCATGTTTGGTGATTTGTCTGTAGGTGT ACGTATGTTTGGTGATCTTTCTGTGGGTGT	8874	3	1.0	CCATGGTGGCTGTGTGCTTGGTACTTTCTT CCATGGTGGTTGTGTACTTGGTACTTTTTG CCGTGGTGGCTGTGCGCCTGGTACTTTTTA	2	1.0	TGTACTGTCGTTATGTCTGTTCTGCTTA TTGTTATGGCTGTTCTGCTTAACAATGT	{8709} {8716}
6.533575410741902	12910	13139	229	12910	3	1.0	GGACTTGTGCTTTGCTCTGCGTAACTTTGA GGATTTGTGCTTCGCTCTGCGTAACTTTGA GGATTTGTGTTTTGCCCTGCGTAATTTTGA	13109	4	1.0	CTTTGCGACGAAATGGTGCTTAGAGGAGTT CTTTGCGATGAAATGGTGCTTAAAGGAGTT CTTTGTGACGAAATGGTTCGCAAGGGCGTT TTTTGCGACGAAATGGTGCTCAAAGGAGTT	2	1.0	CTGATTACTTTGAAATGAAGAATTGGTT TTCTTACTGGTTGTTGTGGTACCGATTA	{12996} {12975}
6.535466666009797	16453	16683	230	16453	5	1.0	CGTAGATGAAGTGTCTATGTGCACCAATTA CGTAGATGAAGTGTCTATGTGCACTAACTA CGTGGATGAGGTGTCTATGTGCACTAACTA TGTAGATGAGGTGTCTATGTGCACCAACTA TGTGGATGAAGTGTCCATGTGCACTAACTA	16653	2	1.0	ACAAATGTTACAGGTGTCCAGCTGAAATAG ACAAGTGTTACAGATGTCCTGCTGAAATAG	2	1.0	CCTAGGGTGCTTATATCCAAAGGAACTA GAGTTCTTATCTCTAAGGGTGTTATGGA	{16559} {16563}
6.539216028494806	13099	13245	146	13099	3	1.0	ATGTGTTGCGCTTTGTGACGAAATGGTTCG GTGTGTTGCTCTTTGCGACGAAATGGTGCT GTGTGTTGCTTTTTGCGATGAAATGGTGCT	13215	4	1.0	CTGGAATGGGAATACCCTACTGCACGTCAT CTGGAATGGGAATACCTTATTGCACATCAT CTGGGATGGGAATACCCTATTGCACGTCAT CTGGTATGGGAATACCCTATTGCACATCAT	4	1.0	CTATGACTTTGGGGATTTCGTTTTGTGT CTATGATTTTGGGGACTTTGTTTTGTGT GACTTCGGTGATTTTGTATTGTGTCCTC TGATTTTGGAGACCTTGTTATGTGTCCG	{13183} {13183} {13187} {13186}
6.545422420167964	5342	5526	184	5342	3	1.0	CGCCACTACATTTGCAACATTAGATCATAG CGCTGTTACTTTTGCAACAGTTGATCATAG TGCTGTAACCTTTGCAACAGTTGATCATAG	5496	4	1.0	GGTCTTGACGCAGCATGGAATAAGTTTGTC GGTCTTGATGCTGCATGGAACAAATTTGTT GGTCTTGATGCTGCATGGAATAAGTTTGTT GGTCTTGATGCTGCGTGGAATAAATTTGTT	3	1.0	AGTACTGTTGTTAATGGTGTCAGAGTCT GAGTGTTGAAAACCAGTAATAATAATTG TGCGTTTGCATATGAAAGTAGTGTTGTT	{5388} {5410} {5372}
6.550207968360733	11566	11804	238	11566	4	1.0	CACGTAATGGTGTTGTACCCCTCTCTGTTA CACGTAATGGTGTTGTCCCTCTCTCTGTTA CACGTAATGGTGTTGTCCCTCTTTCCGTTA CACGTAATGGTGTTGTTCCTCTTTCTGTTA	11774	3	1.0	ACTTGTCTGGCCTCTGATTTTGACATGCGA ACTTGTTTGGCCTCTGATTTTGACTTGTGA ACTTGTTTGGCCTTTGGTTTTGACATGTGA	2	1.0	CCACTTCTGCATCCAAGCTTGTTGTTGT TAAAGATGTTACAAAGGAAAACCAGGAA	{11602} {11744}
6.552003865708118	12020	12259	239	12020	5	1.0	ACCACCTTGCAAATTCGTTGTAGATACACC ACCACCTTGCAGATTTGTTGTAGACACACC ACCACCTTGCAGATTTGTTGTAGATACACC ACCACCTTGCAGGTTTGTCGTAGATACACC ACCTCCATGTAGGTTTGTAGTCGATACACC	12229	2	1.0	ATCTTGATGCTGTTAAACAAGGCGCAAAAC ATCTTGATGCTGTTAGACAAGGTGCAAAAC	2	1.0	CAGACTGAGTTTGTTTCAAATTCCCATT TCGTTAGGAACCTCAATAATTTGAGGAG	{12159} {12079}
6.559088504066715	25242	25485	243	25242	3	1.0	CCTTGAGTGGCTCAACCGTGTAGAAAACTA CTTAAAGTGGCTCAACCGGGTTGAGACTTA TCTTGAGTGGCTCAACCGTGTTGAGACTTA	25455	4	1.0	ACAGTAATGGCTCTAGGTTTGTTCACATTG ACAGTAATGGCTCTAGGTTTGTTTACTCTG ACAGTAATGGCTTTAGGCTTGTTCACATTG TCAGTAATGGCTCTAGGCTTGTTCACACTT	2	1.0	AGGTTGTTGTGAGTCAACTAAACTTCCT GTGGGTTTGGTTGTGCATTTCAGTCGCG	{25401} {25287}
6.564301087828205	17410	17656	246	17410	2	1.0	CGTTGTTGGTGACAACGTTGGCACTAATGT TGTCACAGGTGATAATGTTGGCACTAATGT	17626	5	1.0	CCAAATGATAGCAGATTACCTCGCTGGTTC TCAAATGATAGCAGACTACCTTGCTGGTTC TCAAATGATAGCAGATTATCTCGCTGGTTC TCAAATGATAGCAGATTTTCTTGCTGGCTC TCAGATGATATCTGATTACCTTGCTGGTTC	2	1.0	CTTGGAGTGTTTTGAGAAAGCGCATTGT GGTTGTGTTTTAACAAACACAGGCAGTG	{17598} {17492}
6.567729642842771	9651	9899	248	9651	3	1.0	CGAGGTTCATTTATTAATGGTGCATGTGGT CGTGGTTCATTCATTAATGGTGCATGTGGC CGTGGTTCATTTATTAATGGTGCGTGTGGT	9869	4	1.0	TGCGGCTATATTGAATGGTTGCACCTGGTG TGCTGCCATACTGAATGGTTGTACATGGTG TGCTGCTATATTGAATGGTTGCACATGGTG TGCTGCTATATTGAATGGTTGCATATGGTG	2	1.0	ACAATCTTAAAAATGGCGAGGTGGAATT CCTGGTTACAATCTTAGAGGTAGCGAGG	{9691} {9684}
6.567729642842771	11288	11536	248	11288	4	1.0	AGCAAGACAAGAGTATGAAAATGCTGTTGC AGCAAGACAGGAGTATGAAAATGCTGTTGC GGCAAGACAGGAGTATGAAAACGCAGTTGC TGCACGACAGGAGTATGAAAATGCTGTTGC	11506	3	1.0	TACTCTTTGGCATGCTCCGACGATTGGACA TACTCTTTGGCATGCTCCGTAGGTTGGACA TACTCTTTGGCATGCTCCGTCGTTTGGACA	2	1.0	AAATGGATCGTCACCGCAAATTATTAAG TCAAAAGTTGTTAGTGCAATGCATAGTT	{11318} {11478}
6.571121916171137	17993	18243	250	17993	3	1.0	GACTGGTCAATAACCTACCCTATGATAGCT GACTGGTCAATTACCTATCCTATGATAGCT GATTGGTCAATTACCTACCCTATGATAGCT	18213	4	1.0	ACGATTACATGACACATGGCCAAATGGATG ATGATTACATGACACATGGCCAAATGGAAG ATGATTACATGACACATGGCCAAATGGATG ATGATTACATGACACATGGGCAGTTAGATG	2	1.0	CGTGTGGTACAGAGTCATATTATGCGCG TGCAAAGTCATATCATGCGTGCTGCTAT	{18050} {18057}
6.582028706359163	27015	27214	199	27015	5	1.0	CTCACCTACGAGCAACATGACAGAAAATGA CTCCCCCATGAGCAACATGACAGAAAACGA CTCTCCACAGAGCAATATGACAGAAAATGA CTCTCCTACGAGCAATATGACAGAAAACGA CTCTCCTATGAGCAACATGACAGAAAACGA	27184	2	1.0	CTTGGAAAGTGATACCACGTGACTTGGTAC CTTGGAAGGTGATACCTCGTAATTTGGTAC	3	1.0	ACGTGGTCGTCAGGGCAGAATACCTTAT ATGGCTACGGTCAATTGGGCTGATGAGT GGCTGATGCGTCTGAACCACAACGTGGT	{27119} {27081} {27098}
6.59777901698314	5239	5372	133	5239	4	1.0	AAGACAAAGATCTTTCTGGTGCAGTACCAA AAGATAAAGACCTTTCTGGTGCAGTTCCCA AGGACAAAGATCTTTCTGGTGCAGTACCCA AGGATGTGGACCTTTCTGGTGCAGTGCCAA	5342	3	1.0	CGCCACTACATTTGCAACATTAGATCATAG CGCTGTTACTTTTGCAACAGTTGATCATAG TGCTGTAACCTTTGCAACAGTTGATCATAG	5	1.0	AGCAATAGATGTTGATTGGGTCGCGTTT ATTGGGTGTCGTTTTATGGTTTTTCAGA GTGATCTTAATACGTCAGAATTGCTTAC TAGATGTTGATTGGGTTCAGTTCTATGG TAGATGTTGATTGGGTTGAATTTTATGG	{5300} {5314} {5269} {5305} {5305}
6.643328507007025	6952	7131	179	6952	2	1.0	GTGTAGACTGTGACTCTTATGGTTACGGTA GTGTTGACTGTGACTCTTATGGTTATGGCA	7101	5	1.0	AGATTGCATGCTGGTGAAACATTTTGGCGC AGATTGTATTCCAGTGAAACGTTTTGGCGT AGATTGTATTCCGGTGAAACATTTTGGCGT AGATTGTATTTCGGTGAGACATTCTGGCGC AGGTTGTATTCTGGTGAAACATTCTGGCGT	4	1.0	CATTTATAACACAAGAGGTTTCTAGAGA CTGAAGTTTCTAGAGAACTTGGTAATAT TAACGGCTGAAGTTTCTCGTGAACTTGG TGTCATGGTTGACAAAGTGGAGTTTGAA	{6985} {6997} {6991} {7061}
6.666799999999999	9932	10024	92	9932	4	1.0	CAATGAATGGGCACAGACCAATGGATTTAC TAATGAATGGGCACAGTCCAATGGTTTTAC TAATGAGTGGGCACAGGCTAATGGTTTTAC TAATGAGTGGGCACAGTTTAATGGTTTCAC	9994	4	1.0	TTGCTGCAAAAACCGGTGTCTGTGTTGAGA TTGCTGCTAAAACTGGCGTTTGTGTTGAAA TTGCTGCTAAAACTGGTGTCTGTGTGGAAA TTGCTGCTAAAACTGGTGTCTGTGTTGAAA	2	1.0	AGCCATGAATGGTGAAGATGCCTTTTCC ATGAATGGCGAAGATGCGTTCTCCATTC	{9962} {9966}
6.686234243325825	26951	27045	94	26951	3	1.0	CACGAAACAGCACAGGCTGGGTTTTCTACG CACGTAACAACACAGGTTGGATGTTTTATG CTCAAAATAGCACAGGCTGGGTTTTCTACG	27015	5	1.0	CTCACCTACGAGCAACATGACAGAAAATGA CTCCCCCATGAGCAACATGACAGAAAACGA CTCTCCACAGAGCAATATGACAGAAAATGA CTCTCCTACGAGCAATATGACAGAAAACGA CTCTCCTATGAGCAACATGACAGAAAACGA	2	1.0	CGAGTAAAACACGGTGACTTTTCTGCAG TACGAGTAAAGCACGGTGACTTTTCTGC	{26983} {26981}
6.746343377117347	17568	17657	89	17568	3	1.0	ACCTAGTACCTCTGTTACGCAGGGGACAAC ACCTAGTACCTCTGTTGCGTAAGGGCCAGC ACCTTGTACCTCTGTTACGCAAGGGACAAC	17627	5	1.0	CAAATGATAGCAGACTACCTTGCTGGTTCA CAAATGATAGCAGATTACCTTGCTGGTTCT CAAATGATAGCAGATTATCTCGCTGGTTCA CAAATGATAGCAGATTTTCTTGCTGGCTCA CAGATGATATCTGATTACCTTGCTGGTTCT	3	1.0	CGTGGAGTGTGTTGCGTAAGCGCATTGT GTGGAGTGTGTTGAGAAAGCGCATTGTC TTGGAGTGTTTTGAGAAAACGTATTGTT	{17598} {17599} {17599}
6.775989758004454	2038	2278	240	2038	4	1.0	GCGTTCTGACTACTGCTGTCTACAAACCAC GTGTGTTGACTACTGCAGTCTACAAACCAT GTGTGTTGACTACTGCAGTCTATAAACCAT GTGTTTTGACCACAGCTGTTTACAAACCTC	2248	3	1.0	GTGCACCGCGTTATGTTAAGGATTATGTTG GTGCTCCACTCTATGTGAGAGACTATGTTG GTGTTCCACTTTATGTGAGAGACTATGTTG	4	1.0	TATTCACTTTTAATGTGAATGTTATGGG TGTTCACATTTAATGTGAACGTAGTGGG TGTTTGTGTTTAAAGTTAACGTTGTTGG TTATGGGTACTAGACCTGAAAAATTTCC	{2068} {2068} {2068} {2089}
6.776089758004454	8799	8904	105	8799	5	1.0	TTCTTTGCAACCAGAAGCTTACGGTACGCA TTCTTTGCCACACGTCAATTGCATTATGCA TTCTTTGCTACTAGAAACCTACGCTATGCA TTCTTTGCTACTAGAAGCTTACGCTATGCA TTCTTTGCTACTAGAAGTTTGCGCTACGCA	8874	3	1.0	CCATGGTGGCTGTGTGCTTGGTACTTTCTT CCATGGTGGTTGTGTACTTGGTACTTTTTG CCGTGGTGGCTGTGCGCCTGGTACTTTTTA	2	1.0	TGGATCTGGTGTGCAGCTTATTTGATAG TGGATTTGGTGTGCTGCATATTTAATTG	{8829} {8829}
6.811073809953941	3236	3438	202	3236	3	1.0	TTTGCCCGTTATGTTTTCTGAATGGCCTCT TTTGCCTGTCATGATTTCTGAGTGGCCGTT TTTGCCTGTTATGATTTCTGAATGGCCTCT	3408	4	1.0	GTGAGCCCATTCGACATGCCGTATAATGAG GTGAGTCCTTTTGAAATGCCATTTGAAGAG GTGCGTCCTTTTGAAATGCCATTTGAGGAG GTTAGCCCTTTTGAGATGCCTTACAATGAA	5	1.0	ATAGCATTTTTGACATTGAGACAGTGGA GAAGAGGAGGTTCAACAAGAGCAACAAG GATGAAATTGAAGAAGTCAATAGTAGTT GCGAGTTTGTCGATGAAGTTGAAGAAGT TCCGAATCAGATAAGGAAGGTGAGGTTC	{3367} {3282} {3348} {3337} {3267}
6.846194263681199	11217	11333	116	11217	5	1.0	GAGAACGACGCCATTTTGCAAAGTGTTGCA GAGAACGATAGTATTTTGCAGAGCGTTGCA GAGAATGACACTATATTGCAAAGCGTCGCA GAGAATGACGCCATTTTGCAAAGTGTCGCA GAGAATGACTCCATTTTGCAAAGTGTTGCA	11303	3	1.0	TGAAAACGCAGTTGCAAATGGATCGTCACC TGAAAATGCTGTTGCAAATAGTTCCTCACC TGAAAATGCTGTTGCAAATGGTTCTTCACC	2	1.0	TCATCTTTTGTTGGTATGCCGTCTTTCA TCGTCTTTTGTTGGTATGCCATCTTTTG	{11247} {11247}
6.849332422683973	10858	11078	220	10858	4	1.0	GCCCCGCGGAGTTTAAATACATGATAGCTA GTCCAGCCGAATTTAAGTATATGGTTGCTA GTCCAGCTGAATTCAAATACATGGTTGCTA GTCCAGCTGAATTTAAGTACATGGTTGCTA	11048	3	1.0	GAACATAGCCTCTAATTCAAAGGAGTGGGC GAACATAGCTTCTAACTCAAAGGAGTGGGC GAATATTGCAGCTAATTCAAAAGAGTGGGC	5	1.0	AATGGCCCTTTTGATGCACTCTTTCTGT ACCAAACGGTCCTTTTGATGCGCTTTTT CACCAAATGGTCCATTTGATGCTCTTTT CACCAGATGGCCCTTTTGATGCGCTATT TGGACCTTTTGATGCACTGTTTCTGTCT	{10905} {10901} {10900} {10900} {10907}
6.8494324226839725	13063	13163	100	13063	4	1.0	TGCTTTAGGCAAGGTAGTTGCAAATGCAAT TGCTTTGGGTAAAGTAGTCGCAAATGCAAT TGCTTTGGGTAAGGTAGTCGCAAACGCAAT TGCTTTGGGTACAGTAGTCGCAAATGCAAT	13133	4	1.0	GGAGTTGTTGGTGTCCTAACTCTAGACAAC GGAGTTGTTGGTGTCTTGACCTTAGATAAC GGAGTTGTTGGTGTTTTGACCTTAGACAAC GGCGTTGTTGGTGTTTTGACCCTCGATAAT	3	1.0	TGTTGCGCTTTGTGACGAAATGGTTCGC TGTTGCTCTTTGCGACGAAATGGTGCTT TGTTGCTCTTTGCGATGAAATGGTGCTT	{13102} {13102} {13102}
6.855287395870146	2250	2473	223	2250	3	1.0	GCACCGCGTTATGTTAAGGATTATGTTGAC GCTCCACTTTATGTGAGAGACTATGTTGAT GTTCCACTTTATGTGAGAGACTATGTTGAC	2443	4	1.0	CAATAGATGGAGGCAAGATATGGAATGGAA CTATAGATGGTGGCAAGATATGGGCTAGTA TAATAGACGGTGGCAAGATATGGAGTGGAA TTATAGATGGCGGCAAAATATGGAATGGTG	5	1.0	AAGTGGTATGATTTTTGCAGTCAATATG AATGGGATGACTTCTGCAGTCGATATAG ATGCTGCTGTGAAAGCTGCAGAATCTAA GCTTTTATTAGCGTTTTGGATGTTGCTG TGGGATGATTTTTGCAGGCAGTATAGTA	{2280} {2281} {2368} {2340} {2283}
6.887189758004454	1157	1262	105	1157	3	1.0	AACGCAGAAAGCAGGCGTTGGTATTAAGTA AACTCAGCAAGCTGGTGCTGGTATTAAGTA TACTCAGCAAGCTGGTGTTGGTGTTAAGTA	1232	5	1.0	CTCTGTCTGGCGAGTGATTGCTGTTCAAAG CTCTGTTTGGAGAGTGATTGCTCTTCAGAG CTCTGTTTGGCGAGCAATTGCTGTTCAGAG CTCTGTTTGGCGAGTAATCGCTGTTCAGAG CTCTGTTTGGCGAGTTGTTGCTGTTCAGAG	3	1.0	CTTAAGTTTGTTGCAAACATTGAAGGTG TGAAGTTCGTAGCTAGCATTGAGGGCGT TTTGTGGTATGACACTCAAGTTTGTTGC	{1203} {1204} {1189}
6.894235466635869	11928	12034	106	11928	3	1.0	CGCGCATTTATGTATGCATATGTGACCACA CGTGCATTTATGTATGCATATGTGACTACG CGTGCATTTATGTATGCGTATGTGACCACT	12004	5	1.0	TTACAGTAGAACTGGAACCACCTTGCAGAT TTACAGTAGAGTTAGAACCTCCATGTAGGT TTACAGTTGAACTGGAACCACCTTGCCGAT TTACAGTTGAATTGGAACCACCTTGCAGAT TTGCAGTGGAATTGGAACCACCTTGCAGGT	3	1.0	GTTAAATGGGAACATGACTCCGGTGTGG GTTAAATGGGAGCATGACTCTGGTGTGG TACGTTAAATGGGAACATGAATCGGGTG	{11976} {11976} {11973}
6.917726686365171	13150	13245	95	13150	4	1.0	AACTCTAGACAACCAGGATCTTAATGGGAA GACCCTCGATAATCAGGATCTCAATGGGAA GACCTTAGACAACCAAGATCTTAATGGGAA GACCTTAGATAACCAAGACCTTAATGGGAA	13215	4	1.0	CTGGAATGGGAATACCCTACTGCACGTCAT CTGGAATGGGAATACCTTATTGCACATCAT CTGGGATGGGAATACCCTATTGCACGTCAT CTGGTATGGGAATACCCTATTGCACATCAT	4	1.0	CTATGACTTTGGGGATTTCGTTTTGTGT CTATGATTTTGGGGACTTTGTTTTGTGT GACTTCGGTGATTTTGTATTGTGTCCTC TGATTTTGGAGACCTTGTTATGTGTCCG	{13183} {13183} {13187} {13186}
6.939643925003943	1279	1445	166	1279	5	1.0	CTTCTGCCACTTTTGTGGAAGAAGAACATG CTTCTGCTACCTTTGTAGAAGAGGAACATG CTTCTGCTACTTTTGTAGAGGAGGAACATG CTTCTGCTGATTATGTAGAGGAGGACCACC CTTCTTCCACTTTTGTAGAAGAGGAACATG	1415	3	1.0	TGCTACAGGTGTTATTGATATTAGTGCAGG TGCTGCAGGTGTCATAGACATTAGTACCGG TGCTGCAGGTGTCATTGACATTAGCACCGG	1	1.0	CAGAATGGATACATTCTGCTTCAATGTA	{1313}
6.972333761645286	1157	1300	143	1157	3	1.0	AACGCAGAAAGCAGGCGTTGGTATTAAGTA AACTCAGCAAGCTGGTGCTGGTATTAAGTA TACTCAGCAAGCTGGTGTTGGTGTTAAGTA	1270	5	1.0	GATTTGTTGCTTCTGCTACTTTTGTAGAGG GCTTTGTTGCTTCTGCCACTTTTGTGGAAG GCTTTGTTGCTTCTGCTACCTTTGTAGAAG GCTTTGTTGCTTCTTCCACTTTTGTAGAAG GTTTTGTTGCTTCTGCTGATTATGTAGAGG	2	1.0	CTTAAGTTTGTTGCAAACATTGAAGGTG GTCTGGCGAGTAATCGCTGTTCAAAGTG	{1203} {1236}
6.974023285568202	965	1084	119	965	5	1.0	GACAAATGGTTCCAACATCCTAGAGGCCTT GACAAATGGTTCTAACATCTTAGAGGCCTT GACCAATGGTTCTAACATCTTAGAGGCTAT GACCAATGGTTCTACCATTTTGGAGGCCAT GACTAATGGTTCCAACATCTTAGAGGCCAT	1054	3	1.0	CTGTCGGTGATTGGACTGGTTTTAAATCCA CTGTGGGTGATTGGACCGGTTTTAAATCCT CTGTTGGTGATTGGACCGGATTTAAATCCT	3	1.0	AAACCTGTGTTCATTAGTGCACTAGTTC AAACCTGTGTTCATTAGTGCATTTGTTC TTAAGCCTGTGTTTATCAGTGCATTAGT	{999} {999} {997}
7.059690556965433	9512	9681	169	9512	5	1.0	AGTCTCACAGACTAACATGTGCACTCCGAA AGTTTCACAGACTAACATGCACACACCTAG GGTGTCACAGACTAACATGCATACACCTAG GGTTTCACAGACTAACATGCACACACCTAG GGTTTCACAGACTAATATGCATACACCTAG	9651	3	1.0	CGAGGTTCATTTATTAATGGTGCATGTGGT CGTGGTTCATTCATTAATGGTGCATGTGGC CGTGGTTCATTTATTAATGGTGCGTGTGGT	2	1.0	ATGATGGTTGTGCCCAAGGTGTTTTCGG TTTTGGTGTTAACATGAGAACTAATTGG	{9595} {9617}
7.074068161147405	2969	3143	174	2969	5	1.0	TACAAAAGCCGCTGGTGGTAAAGTTTCATT TACAAAATCCGCTGGTGGTAAGGTTTCATT TACTAAAGCCGCCGGTGGCAAAGTTTCTTT TACTAAAGCCGCCGGTGGTAAAGTTTCTTT TACTAAGGCTGCCGGTGGCAAAGTTTCTTT	3113	3	1.0	AAAACATGAGGGTGATTGGGACAGTTTTTG TAAACATGAAGGTGACTGGGATAGCTTTTG TAAACATGAGGGTGACTGGGATAGTTTTTG	2	1.0	TACAGAGTCAAGCTTTGCTTTGAGTTTG TACAGGGTTAAGCTTTGCTTCGAGTTTG	{3036} {3036}
7.074068161147405	25311	25485	174	25311	4	1.0	CGCGCTCATCTTTGTGGTGAGTATGTTACT CGTGCTCATCTTTGTGGTGAGTATTTTGCT TGTCCTAATTTTTACTGTGGGCTTGCTCTT TGTGTTGATTTTTGTGGTGGGCTTGCTGAT	25455	4	1.0	ACAGTAATGGCTCTAGGTTTGTTCACATTG ACAGTAATGGCTCTAGGTTTGTTTACTCTG ACAGTAATGGCTTTAGGCTTGTTCACATTG TCAGTAATGGCTCTAGGCTTGTTCACACTT	2	1.0	AGGTTGTTGTGAGTCAACTAAACTTCCT GCTGTGGTTTCTTTAGTTGTCTTGCTTC	{25401} {25364}
7.07686788931984	1062	1237	175	1062	5	1.0	GATTGGACCGGATTTAAATCCTCTTGTTGT GATTGGACCGGTTTTAAATCCTCCTGCTGC GATTGGACCGGTTTTAAATCCTCTTGTTGC GATTGGACCGGTTTTAAGTCCTCTTGTTGT GATTGGACTGGTTTTAAATCCACCTGCTGT	1207	3	1.0	AGTTCGTAGCTAGCATTGAGGGCGTTTCTG AGTTTGTTGCAAACATTGAAGGTGTCTCTG AGTTTGTTGCAAGCATTGAATGTGTCGCTG	2	1.0	AACAATCTTAGTAAGAGATTGTGTGTTG GCTGTGATTACAACTCAGCAAGCTGGTG	{1092} {1146}
7.07686788931984	9807	9982	175	9807	5	1.0	CCTAACCTTCAAGTTGAATCTGCAAACCAG CCTAACCTTCAAGTTGAATCTGCAAGTCAA CCTAACCTTCAAGTTGAATCTGCCAACCAG CCTAACCTTCAGGTTGAATCTGCGAACCAG CCTAATCTTCAAGTTGAATCTGCAAACCAG	9952	3	1.0	ATGGTTTCACAGCTATGAATGGTGAAGACG ATGGTTTTACAGCCATGAATGGTGAAGATG ATGGTTTTACAGCTATGAATGGCGAAGATG	2	1.0	ACATGGTGGCTTAAAGGCGACAAATTGT TAGAACATTATAATGAGTGGGCACAGGC	{9891} {9922}
7.079548055426138	25242	25384	142	25242	3	1.0	CCTTGAGTGGCTCAACCGTGTAGAAAACTA CTTAAAGTGGCTCAACCGGGTTGAGACTTA TCTTGAGTGGCTCAACCGTGTTGAGACTTA	25354	5	1.0	GCCACAGGTTGTTGTGGCTGCTGTAGTTGT GCTACAGGTTGTTGTGGCTGTTGTAGTTGT TCCACTGGTTGTTGCGGCTTCTTTAGTTGT TCTACTGGTTGCTGCGGTTTCTTTAGTTGT TCTACTGGTTGCTGTGGCTTCTTTAGTTGT	3	1.0	CTTGGTGGGTGTGGTTGTGTATAGTCAT GTGGGTTTGGTTGTGCATTTCAGTCGCG TTGTGTATTGTGATTGTGTTGATTTTTG	{25283} {25287} {25297}
7.079643377117346	5496	5614	118	5496	4	1.0	GGTCTTGACGCAGCATGGAATAAGTTTGTC GGTCTTGATGCTGCATGGAACAAATTTGTT GGTCTTGATGCTGCATGGAATAAGTTTGTT GGTCTTGATGCTGCGTGGAATAAATTTGTT	5584	4	1.0	GTGACAAGGGTGATGCTGAAGACACTTTGA GTGCCAAAGGTGATGCTGAAGACACTTTGA GTGCTAAGGGTGATGCTGAAGATATTTTGA GTTCTAAGGGTGATGCTGAAGACACTTTGA	4	1.0	CTCGGTGATGTACAGACATTTGTAGCAT GGCGATGTTGAAATTTTTGTTGCATTTG TAGGCGATGTTGAAACTTTTGTCGCATT TTGGAGATGTTAAAACCTTTGTTGCTTT	{5526} {5529} {5527} {5527}
7.098426723086379	383	566	183	383	3	1.0	CTATAGCGAGGCCGCTAGCAATGGATTTAG TTATAGCGAGGCCGCTAGCAATGGTTTTAG TTATAGCGAGGCCGCTGTCAATGGTTTTAG	536	5	1.0	CCCCTTTATGCTTAGAGGGTGGTTGGTGTT GCCTTTTGGTTTACGAGGTTGGTTAGTCTT TCCCTTTATGCTTCGTGGTTGGTTGGTTTT TCCTTTTATGCTTAGAGGGTGGTTGGTCTT TCCTTTTATGCTTCATGGGTGGTTGGTTTT	2	1.0	AGCATGCCGATTTGTTTCATTTGGTTTG CCTGCAATATAATGAAATTTTCTGACCG	{413} {508}
7.102185705661207	1239	1343	104	1239	5	1.0	TGGAGAGTGATTGCTCTTCAGAGTGTTGAT TGGCGAGCAATCGCTGTTCAGAGTGTTGAT TGGCGAGTAATCGCTGTTCAGAGTGTGGAT TGGCGAGTGATTGCTGTTCAAAGTGTAGAT TGGCGAGTTGTTGCTGTTCAGAGTGTAGAT	1313	3	1.0	CAGAATGGATACATTCTGCTTCAATGTACG TAGAATGGACACATTCTGCTTCAATGTACG TAGAATGGATACACTCTGCTTCAATGTGCG	5	1.0	GCTTTGTTGCTTCTTCCACTTTTGTAGA TGCTTCTGCTACCTTTGTAGAAGAGGAA TGCTTCTGCTGATTATGTAGAGGAGGAC TTCGTTGCTTCTGCCACTTTTGTGGAAG TTGCTTCTGCTACTTTTGTAGAGGAGGA	{1270} {1277} {1277} {1272} {1276}
7.106151599001681	9166	9289	123	9166	3	1.0	AAGCAATGCTGGATTTTTCGCGTGATCATA AAGCAATGTTGGACTTTTCGCGTGATCATA AGGCCATGATGGACTATTCGCGTGATCATA	9259	5	1.0	AAATGGCACAACCATCTGGCATAGTGGAAA AAATGGCACAACCATCTGGCATTGTGGAGA AAATGGCACAACCATCTGGCTTTGTGGAAA AAATGGCACAGCCATCTGGCATTGTGGAAA AAATGGCGCAGCCGTCTGGCATTGTTGAAA	4	1.0	ATACACACCTCCAACTGTCAGTTATGGG CGGTTCTACATTACAGGCAGGTTTGCGT GGTTCGACCTTGCAAGCAGGTTTGCGTA TCAGTTACGGTTCTACATTACAGGCAGG	{9206} {9230} {9231} {9223}
7.111165756109888	5584	5825	241	5584	4	1.0	GTGACAAGGGTGATGCTGAAGACACTTTGA GTGCCAAAGGTGATGCTGAAGACACTTTGA GTGCTAAGGGTGATGCTGAAGATATTTTGA GTTCTAAGGGTGATGCTGAAGACACTTTGA	5795	4	1.0	CTCACGAGTCAGGAGTGTTAGTGGGCGTGC TTCACGTGTTAAAAGTGTTAGAGGTAGAGC TTCACGTGTTAAGAGTGTCAGTGGTAGAGC TTCACGTGTTAGAAGTGTTAGCGGTAGAGC	1	1.0	TTGTGCTAGTGTCAAACGTGATGGTGTG	{5732}
7.11293196905215	415	566	151	415	3	1.0	CATGCCGATTTGTTTCATTAGATTTGCAGG CATGCCGATTTGTTTCATTTGGCTTGCATG CATGCCGATTTGTTTCATTTGGTTTGCAAG	536	5	1.0	CCCCTTTATGCTTAGAGGGTGGTTGGTGTT GCCTTTTGGTTTACGAGGTTGGTTAGTCTT TCCCTTTATGCTTCGTGGTTGGTTGGTTTT TCCTTTTATGCTTAGAGGGTGGTTGGTCTT TCCTTTTATGCTTCATGGGTGGTTGGTTTT	3	1.0	CAAAGACTATGTTATGGGTCTGCATGGT CCTGCAATATAATGAAATTTTCTGACCG GTGTTGCTGGTGATGACTATGTTGTGGG	{467} {508} {457}
7.113694696155046	11615	11804	189	11615	5	1.0	CAAACTCGTCGTTGTAGTACCAGATCATGA CAAGCTCGTCGTCGTGGTGCCAGATCATGA CAAGCTTGTTGTTGTAGTACCAGATCATGA CAAGCTTGTTGTTGTAGTGCCAGATTATGA CAGGCTCGTCGTCGTAGTGCCAGATCATGA	11774	3	1.0	ACTTGTCTGGCCTCTGATTTTGACATGCGA ACTTGTTTGGCCTCTGATTTTGACTTGTGA ACTTGTTTGGCCTTTGGTTTTGACATGTGA	2	1.0	GCTAAAATGTTGGTAGATGGTTTTGTGC TAAAGATGTTACAAAGGAAAACCAGGAA	{11652} {11744}
7.118626590941621	11671	11862	191	11671	3	1.0	GCTTTGTTCACTACGCAGGTGTTGTTTGGA GTTTTGTGCACTACGCTGGCGTTGTTTGGA GTTTTGTTCACTACGCGGGTGTTGTTTGGA	11832	5	1.0	ATAATGCCAGGCAAGATGAAGGTCAAGGCC ATAATGCCAGGTAAAATGAAGGTCAAAGCC ATAATGCCAGGTAAAATGAAGGTTAAGGCC ATAATGCCAGGTAAGATGAAAGTCAAAGCC ATAATGCCGGGCAAGATGAAGGTTAAAGCC	2	1.0	CAAGAGGTTAAAGACAATGATGGTAGGA TAAAGATGTTACAAAGGAAAACCAGGAA	{11706} {11744}
7.123329642842771	10858	10965	107	10858	4	1.0	GCCCCGCGGAGTTTAAATACATGATAGCTA GTCCAGCCGAATTTAAGTATATGGTTGCTA GTCCAGCTGAATTCAAATACATGGTTGCTA GTCCAGCTGAATTTAAGTACATGGTTGCTA	10935	4	1.0	TTTAAACTAATGGGTATTGGCGGTCCTAGA TTTAAACTGATGGGTATTGGCGGTCCTAGG TTTAAACTGATGGGTATTGGTGGTCCTAGA TTTAAGCTTATGGGTATTGGTGGACCTAGA	5	1.0	AATGGCCCTTTTGATGCACTCTTTCTGT ACCAAACGGTCCTTTTGATGCGCTTTTT CACCAAATGGTCCATTTGATGCTCTTTT CACCAGATGGCCCTTTTGATGCGCTATT TGGACCTTTTGATGCACTGTTTCTGTCT	{10905} {10901} {10900} {10900} {10907}
7.125885018119717	27099	27293	194	27099	4	1.0	GCTGATGAGTCTGAGCAGCAGCGTGGTCGT GCTGATGCATCTGAACCACAACGTGGTCGT GCTGATGCTTCTGAACCACGGCGTGGTCGT GCTGATTCCTCTGAACCACAACGTGGTCGT	27263	4	1.0	AAAACGCTTCAGAACTAAGAAAGGTCAGAG AAAACGCTTCAGAACTCGTAAAGGGCAGCG AAAACGTTTCAGAACTAGAAAGGGCAAACG GAAAAGATTCCGCACTAGGAAGGGCAAGAA	2	1.0	CCTTGGAAAGTGATACCTCGTGACTTGG TTGGAAGGTGATACCTCGTAATTTGGTA	{27183} {27185}
7.132982728833828	8245	8442	197	8245	4	1.0	GATTAGAAGGTCTGGGTGGTAACAATGTTT GATTAGAGGGTCTTGGTGGTAACAATGTTT GATTGGAAGGTTTGGGTGGTAACAATGTTT GGCTAGAAGGTTTGGGTGGTGATAATGTTT	8412	4	1.0	CGCACTGTAGCAACCAAGTACTGCCGTGTA CGTACCATCGCTACTAAGTACTGTAGAGTT CGTACTATTGCTACCAAATACTGCCGCGTA CGTACTATTGCTACCAAATATTGCCGTGTA	2	1.0	ATATGACAATGGTAATTTTATTAAGTTG CTCATGGAAGGCTCTTTGCCTTATAGTT	{8345} {8292}
7.146723411032158	667	870	203	667	4	1.0	GAAAACCTGTCATAAGTGAAGAATTGTGGC GCAAACCTGTCATAAATGAAGATTTGTGGC GCAAACCTGTCATAAGTGATGATTTATGGC GCAAACCTGTTATGAGTGAAGATTTATGGC	840	4	1.0	GATGCTTTGCATACACTACGCAATGGTTCT GATGCTTTGCATACACTACGTAACGGTTCT GATGCTTTGCATACACTGCGTAATGGTTCT GATGCTTTGCATACGTTGCGCAATGGTTCT	2	1.0	CAATGGTCATACTTACGTTTGTGCTTGG GTATGTTTGTGCATGGCTCACTAAACGT	{737} {749}
7.148957335320481	8801	9005	204	8801	5	1.0	CTTTGCAACCAGAAGCTTACGGTACGCATG CTTTGCCACACGTCAATTGCATTATGCATG CTTTGCTACTAGAAACCTACGCTATGCATG CTTTGCTACTAGAAGCTTACGCTATGCATG CTTTGCTACTAGAAGTTTGCGCTACGCATG	8975	3	1.0	ATTTGTAGGTACATTTGAAAGTGCTGCTGC GTTCGTAGGCACATTTGAAAGTGCTGCTGC GTTTGTGGGTACATTCGAAAGTGCTGCAGC	2	1.0	GATCTGGTGTGCAGCTTATTTGATAGCC GCCCCATGGTGGCTGTGTGCTTGGTACT	{8831} {8871}
7.148957335320482	1894	2026	132	1894	4	1.0	CATCTAGAGTTGAACGCAGCACGGCAGTTC CATCTAGGATTGAACGCAGCACTGCAGTTT CTTCACGTGTTGAACGTAGCACTGCTGTAC CTTCGCGTGTGGAGCGTAGTACAGCTTTGC	1996	4	1.0	TTGCTAGTGACGGCTACTTCCGTCTTATGG TTGTTAGTGATGGCTACTTCCGTCTTATGG TTGTTAGTGATGGTTACTTTAGGCTCATGG TTGTTAGTGATGGTTACTTTCGCCTCATGG	4	1.0	CCAAACTTTCTGATGAAGGGTATACTGT CCCAAACTTTCAGATGAGGGGTATACTG CCGAAGCTTTCTGATGAAGGGTATACTG GCACACAGTTATCCCAAGTTGTCTGACG	{1945} {1944} {1944} {1932}
7.15573770537095	17492	17656	164	17492	3	1.0	GGTTGTGTTATAACAAACACGGGCAGTGTT GGTTGTGTTGTAACAAACACTGGTAGTGTT GGTTGTGTTTTAACAAACACTGGCAGTGTT	17626	5	1.0	CCAAATGATAGCAGATTACCTCGCTGGTTC TCAAATGATAGCAGACTACCTTGCTGGTTC TCAAATGATAGCAGATTATCTCGCTGGTTC TCAAATGATAGCAGATTTTCTTGCTGGCTC TCAGATGATATCTGATTACCTTGCTGGTTC	3	1.0	ACGCAAGGGACAACCGTGGAGTGTGTTG CTTGGAGTGTTTTGAGAAAGCGCATTGT GCAAGGGACAACCTTGGAGTGTGTTGAG	{17584} {17598} {17586}
7.174616373031191	16530	16746	216	16530	5	1.0	ATGTTGGCGACCCTCAACAGCTTCCAGCCC ATGTTGGTGACCCTCAACAATTGCCAGCTC ATGTTGGTGACCCTCAACAGTTGCCTGCTC ATGTTGGTGATCCTCAACAGCTGCCAGCTC ATGTTGGTGATCCTCAACAGCTTCCAGCTC	16716	3	1.0	AGTTTGTACCAGTCAAAGAGGCCAGTAAGC AGTTTGTACCCGTCAAAGAGGCTAGTAAGC AGTTTGTACCTGTCAAAGAAGCTAGTAAGC	2	1.0	AGGGTGCTTATATCCAAAGGAACTATGG GAGTTCTTATCTCTAAGGGTGTTATGGA	{16562} {16563}
7.180722592664184	11114	11333	219	11114	5	1.0	TGACGACCCTGAAACTGCTCAAGAGTTATT TGACGACCCTGAGACGGCGCAGGAGCTTTT TGACGACCCTGAGTTAGCCCAAGAGCTGCT TGATAACCCCGAAACTGCTCAGGAGCTGTT TGATGACCCTGAAACTGCTCAAGAATTGTT	11303	3	1.0	TGAAAACGCAGTTGCAAATGGATCGTCACC TGAAAATGCTGTTGCAAATAGTTCCTCACC TGAAAATGCTGTTGCAAATGGTTCTTCACC	2	1.0	TCGTCTTTTGTTGGTATGCCATCTTTTG TGATTTTGGTCTTAGTGATTTAGTTGAT	{11247} {11180}
7.185168161147406	1894	2068	174	1894	4	1.0	CATCTAGAGTTGAACGCAGCACGGCAGTTC CATCTAGGATTGAACGCAGCACTGCAGTTT CTTCACGTGTTGAACGTAGCACTGCTGTAC CTTCGCGTGTGGAGCGTAGTACAGCTTTGC	2038	4	1.0	GCGTTCTGACTACTGCTGTCTACAAACCAC GTGTGTTGACTACTGCAGTCTACAAACCAT GTGTGTTGACTACTGCAGTCTATAAACCAT GTGTTTTGACCACAGCTGTTTACAAACCTC	3	1.0	AGTTACCCTAAACTTTCGGATGAAGGGT CCTAAACTTTCTAGTGAAGGGTATACTG GCCGTAATTGGCGATGTGGCGTACTTTG	{1938} {1944} {1971}
7.190648055426138	27844	27986	142	27844	4	1.0	AACATGAATTGCAGAAACCTCGCTGGAAGC AACATGAGATGCAGAAGCCGCGCTGGAAGC AGAAAGAACTTGAAAAACCCCGCTGGAAGA AGCATGAAATGCAAAAACCACGGTGGAAAA	27956	4	1.0	CACCATCCAAAAAGGCGTGAAAGCCCCTAA GTTGTTAGCTAATGGTGTTAAAGCCAAAGG TGTTGTAGCTAATGGTGTCAAAGCCAAAGG TGTTGTGGCCAATGGTGTTAAAGCTAAAGG	4	1.0	AGCCTAATGATGAGTTGCCATCCAGCGT ATCATCAAATGTCACTCAATGTTTTGGG CATCTAATGTCACACAGTGCTTTGGGCC TGACATCTAATGTCACACAATGTTTTGG	{27877} {27893} {27895} {27892}
7.200275410741901	4998	5227	229	4998	5	1.0	CAACGATGCACACGTAAGTTGAATAGACTT CAACGGTGCACGCGTAAGCTGAATAGACTT CAACGGTGTACACGTAAGCTGAATAGACTT CAGAGGTGTACACGTAAGTTAAATAGGCTT CAGCGATGTACACGTAAGTTGAATAGACTT	5197	3	1.0	CAGACAAGTCATTTGAACAACAAGTTGGTG CGGACAAACCATTTGAGCAGCAGGTTGGCG CGGATAAGTCGTTTGAGCAACAAGTTGGTG	2	1.0	ATGTGTGATATAGTTTGTACTATACCAG TGACATAGTTTGTAACATACCAGCTGTG	{5028} {5033}
