cost	target-start	target-end	target-length	left-primer-start	left-primer-num-primers	left-primer-frac-bound	left-primer-target-sequences	right-primer-start	right-primer-num-primers	right-primer-frac-bound	right-primer-target-sequences	num-guides	total-frac-bound-by-guides	guide-target-sequences	guide-target-sequence-positions
2.5126942636811997	4001	4089	88	4001	1	1.0	GTACAGGATCCAGCACCTATTGACATTGAT	4059	1	1.0	CTGTATATTTAGGTGTTAAGGGTTCTGGTC	1	1.0	GCTTTCCCTGTGAAACCTATATGTTCAT	{4031}
2.5126942636811997	8550	8638	88	8550	1	1.0	GTTACATTTGTGGTGATGGTCTTATAGACC	8608	1	1.0	TTCATCTTTTAGCGTTGTGGCTATGTCTGG	1	1.0	TTCTTGTTAATGTACTCTCAATCTTTAG	{8580}
2.5126942636811997	14492	14580	88	14492	1	1.0	TTTCAGCCATGGTGTTGGGCTCTAAGCATG	14550	1	1.0	TTATAGGCTTGGTAATGAGTTGGCACAAGT	1	1.0	TTAATTGTTGTACTGTAACAGATAGGTT	{14522}
2.5126942636811997	26078	26166	88	26078	1	1.0	GCTGCACCTACAGGTGTTACATTAACACTT	26136	1	1.0	ATAAGATTGCTACTCGTGTTCAAGTGGGTC	1	1.0	CTTAGTGGTGTACTTCTTGTTGATGGCC	{26108}
2.5126942636811997	26492	26580	88	26492	1	1.0	CCCTATTGGTAAGGGTAATAAAGATGAGCA	26550	1	1.0	TGGCGTATGCGCAGGGGGCAACGTGTTGAT	1	1.0	GATTGGTTATTGGAATGTTCAAGAGCGT	{26522}
2.5126942636811997	26907	26995	88	26907	1	1.0	TCTTCTTCAGATCTTGTTGCTGCTGTTACT	26965	1	1.0	ACCAGTCGAAGTCACCTAGTTCTTCTGGTA	1	1.0	TTGGCTTTAAAGAACTTAGGTTTTGATA	{26937}
2.5126942636811997	27100	27188	88	27100	1	1.0	ATGTTATTCAGTGCTTTGGTCCTCGTGATT	27158	1	1.0	TGTTCAGAATGGTGTTGATGCCAAAGGTTT	1	1.0	TTAATCACAATATGGGGGATTCAGATCT	{27130}
2.5239433771173467	5794	5883	89	5794	1	1.0	TTGTGATGTTGGTTTTTGTCCACACAGACA	5853	1	1.0	ATGGACGTGTTGTTATTACCAATGTTGGTG	1	1.0	TAAATTGCGTTCACGTGTTAAGTTTGTT	{5824}
2.5239433771173467	26773	26862	89	26773	1	1.0	CTGTTGTTGAGTTTGAGGATCGCTCTAATA	26832	1	1.0	ACTCGTAACAACTCACGAGACTCTTCTCGT	1	1.0	CTCATCTCGTGCTAGCAGTCGTTCTTCA	{26804}
2.534811090344213	5413	5503	90	5413	1	1.0	GGATGTAAAGCCATATGGTTACCCTAATGA	5473	1	1.0	CACCGACAATAATTGTTGGGTTAATGCAAC	1	1.0	TTGTTGGTGGTTTTAGAGTTCTTGGGAC	{5445}
2.534811090344213	23276	23366	90	23276	1	1.0	TCAGAGAAACATTCATTCAAGCCGTATAGC	23336	1	1.0	TAGCAAAGTTGTTACATCTGGTTTGGGTAC	1	1.0	AGGACGTAGTGCTTTGGAAGATTTGTTG	{23306}
2.5453224201679636	8117	8208	91	8117	1	1.0	CGTATTAATGTTGTTCCTGGTGTTCCAACA	8178	1	1.0	TTACATTACAGGCTGCTTTTGGAAACACAG	1	1.0	AATGTATATTTGGTAGGAAAGACTCTTG	{8147}
2.5555	24821	24913	92	24821	1	1.0	AAGAGTGTGGCTAATCTCAAATTACCACCT	24883	1	1.0	ACCTGTTACTACACTTAGTACTATCACTGC	1	1.0	CATGATGTTACTGTCTTGCGTGACAATC	{24851}
2.5555	25638	25730	92	25638	1	1.0	CCTGTTCCAGCTGAAGTACTAAATGTCTAA	25700	1	1.0	TCAGAGGTTTATGTCCATTTACGTAACTGG	1	1.0	TAAACGATGTCTAATAGTAGTGTGCCTC	{25670}
2.5555	27296	27388	92	27296	1	1.0	GCTTGTAGCTAAGGATAATAAGAACCTTCC	27358	1	1.0	AACCCAGTTCTATCAAAGAAATGCAGTCAC	1	1.0	TAAGTTCATTGAGCAGATTAGTGCTTTT	{27326}
2.565364373321448	480	573	93	480	1	1.0	CTGTTGCAAGTGATTCGGAAATTTCAGGTT	543	1	1.0	CTTATAGCGAAGCCGCTGCACAAGGTTTTC	1	1.0	TTGGTTTTGCCATTCCTTCTGTAGCCGT	{510}
2.565364373321448	11892	11985	93	11892	1	1.0	GCAAAAACCTATGAAAGCTGAGGGTGATGG	11955	1	1.0	TACTGAGGGTGGTAAAACTTTTATGTACGC	1	1.0	TGGTGTTTTAGGTGATGGTAATGCCTTG	{11922}
2.5749342433258255	23459	23553	94	23459	1	1.0	TGTTGCTGATGCTGAACGTATGGCCATGTA	23523	1	1.0	GGTCTTACATCAGCAGCCGCCATACCTTTT	1	1.0	TACAGGTTCTCTTATAGGTGGCATGGTG	{23489}
2.6020405378427527	743	840	97	743	1	1.0	GTTCTTCAGGACTTTGATGTTGTTTTTGGC	810	1	1.0	TGTGTGGTTTTGATGGTAAACCTGTGTTAC	1	1.0	CATGGTGCAGGAAGTGTGGTTTTTGTGG	{773}
2.6020405378427527	9760	9857	97	9760	1	1.0	ACACCAAATTGAGTTAGGTAGTGGTGCTCA	9827	1	1.0	TTTGATGACCAACCTAGTTTGCAAGTTGAG	1	1.0	TGTTGGTTCTGATTTTACTGGTAGTGTT	{9790}
2.6020405378427527	9981	10078	97	9981	1	1.0	GGCTATGGCTAATGGTTATACAAGTGTTTC	10048	1	1.0	GGTGTTAGTGTTGAACAATTGTTAGCTTCC	1	1.0	GAGTGCTATTCTATTTTGGCAGCAAAAA	{10018}
2.6237942636811997	25174	25262	88	25174	1	1.0	TTCAGGCAAGTGTTGGTATCTTGAACAATC	25232	1	1.0	TATGGTGGTGACCACTATGTCGTTTTAGGT	2	1.0	ATTTTATGAAAATCGTTTTGCTGCTATT ATTTTATGAAACTCGTTCTGCTGCTATT	{25204} {25204}
2.6349480554261384	25771	25872	101	25771	1	1.0	GTTGCAGTATGGGCATTATAAGTATAGCAG	25842	1	1.0	GGCCACTTGTTCTAGCTTTGTCTATTTTTG	1	1.0	ATGGTTTAAAGATGTCTGTTTTATGGTG	{25809}
2.6575857056612073	25369	25473	104	25369	1	1.0	TGTCATTTACATTTTTGCCGAAGAGCCTGT	25443	1	1.0	CGATTAATTGATGACAATGGCATTGTCCTC	1	1.0	TGTTGGTATAGTCTACTCTTCTCAACTA	{25399}
2.6575857056612073	26525	26629	104	26525	1	1.0	TGGTTATTGGAATGTTCAAGAGCGTTGGCG	26599	1	1.0	TTTATTACCTAGGTACTGGACCTCATAAGG	1	1.0	TATGCGCAGGGGGCAACGTGTTGATTTG	{26555}
2.6647897580044537	18617	18722	105	18617	1	1.0	ATAGGTGGTGCTGTTTGTTCAAAACATGCA	18692	1	1.0	GCTGGTTTTAACATTTGGGTACCACATAGT	1	1.0	AATTTGTATCAAAAATATGTTGAGGCAT	{18647}
2.6718354666358684	12187	12293	106	12187	1	1.0	CAAGCTGGTAAACAAACTGAATTGGCTGTT	12263	1	1.0	CTACTTACTTGGAAGCTGTTAAACATGGTG	1	1.0	AATTCTGGACTTTTAACTGCTTGTGCTT	{12217}
2.6718354666358684	23883	23989	106	23883	1	1.0	AGATTAATTACTGGACGGCTTGCAGCTTTG	23959	1	1.0	GTTCCAGACGCTTAGCACAGCAGAAGATTA	1	1.0	AATGCATTTGTTTCTCAAGTTTTGAATA	{23913}
2.678729642842771	3017	3124	107	3017	1	1.0	GTTTTTGTTGAACCTAAGGATGGTGGTCAA	3094	1	1.0	TTATCCAGCTTCATGTAATGGTGTATTGCC	1	1.0	TTTTTTGTTTCTGGTGATTATCTTTGGT	{3047}
2.678729642842771	27219	27326	107	27219	1	1.0	GCTGCGTTATTCTTTGATAGTGAGGTTAGC	27296	1	1.0	GCTTGTAGCTAAGGATAATAAGAACCTTCC	1	1.0	ACTGATGAAGTGGGTGATAATGTTCAGA	{27249}
2.685478667660241	3777	3885	108	3777	1	1.0	CACTTGGTGATAGTGGTAAACTTCTTAGTG	3855	1	1.0	GTGATTGTGGTAAAAAGTTTGATGAGCAGG	1	1.0	GAAAAATATACATGTTCTATAACTTTTG	{3818}
2.685478667660241	26994	27102	108	26994	1	1.0	ACTTCCACTCCTAAGAAACCTAATAAGCCT	27072	1	1.0	TGGAAGCGTGTTCCTACCAGAGAGGAAAAT	1	1.0	ACCCAGGGCTGATAAGCCTTCTCAGTTG	{27032}
2.6985648453679434	3102	3212	110	3102	1	1.0	CTTCATGTAATGGTGTATTGCCAGTTGCTT	3182	1	1.0	CATGATGTTGAACCTACCCATAAAGTCAAG	1	1.0	CAAAATTAGCAGGTGGTAAAATATCTTT	{3135}
2.704912910986066	26206	26317	111	26206	1	1.0	AATTGTTTGTGACCGTGTTGGTCGCTCTGT	26287	1	1.0	TGATTTTTCTGGTGTTGCCTCTCAGGAGGG	1	1.0	TAATGAAACAAGCCAGACTGGTTGGGCA	{26236}
2.7111377053709504	21730	21842	112	21730	1	1.0	GCCCTTCCTCTCAACCTTATTACTGTTTTA	21812	1	1.0	ACCCACTGTGCGTGAGATTGTTGTTGCTAG	1	1.0	ATGTTAGCACTTTTGTGGGTGTCCTACC	{21784}
2.7172439250039426	24782	24895	113	24782	1	1.0	GGTGGCCTATTTCAACTTACTCTTGAAAGT	24865	1	1.0	CTTGCGTGACAATCTTAAACCTGTTACTAC	1	1.0	TCAAATTACCATCTCATGATGTTACTGT	{24837}
2.7348942636811997	26601	26689	88	26601	1	1.0	TATTACCTAGGTACTGGACCTCATAAGGAC	26659	1	1.0	TTGTTTGGGTTGCTAAGGAAGGTGCTAAAA	3	1.0	CTTAAATTCAGACAACGTCTTGATGGTG CTTAAATTCAGACAACGTTCTGATGGTG CTTAAATTCAGACAACGTTTTGATGGTG	{26631} {26631} {26631}
2.7405681611474058	21941	22058	117	21941	1	1.0	GACGGTTGCATTTGCTACTTTTGTTGATGT	22028	1	1.0	TGAAAAGTTGCAGTGTGAGCACTTGCAGTT	1	1.0	AAAACTTACTGTATTGCGATTCTCCATT	{22000}
2.7405681611474058	24111	24228	117	24111	1	1.0	GATTACAAGAATGTAAAGGCGTGGTCGGGT	24198	1	1.0	TCTGATAATGGTGTCTTTCGTGTAACTTCC	1	1.0	GCTATGTTCTGCGTCAACCTAACTTGGT	{24163}
2.7461433771173467	13676	13794	118	13676	1	1.0	CACACTCAGTTAGGTTGACAATTACTGAAC	13764	1	1.0	TCAACGCACTATTTGTTTTTCTGTTGCAGC	1	1.0	CCTTCCTTGATAATATCTTCTTCCCCAG	{13726}
2.7461433771173467	14765	14883	118	14765	1	1.0	CAACGACGTCTGTATGATAATTGCTATAGG	14853	1	1.0	TTTCAATGATGATTCTCTCTGATGACGGTG	1	1.0	TTAACTAGTGTTGAAGAGTCTTTCATTG	{14795}
2.751623285568201	26281	26400	119	26281	1	1.0	ACATGGTGATTTTTCTGGTGTTGCCTCTCA	26370	1	1.0	GCTAGTGTAAATTGGGCCGATGACAGAGCT	1	1.0	GGAGGGTGTTTTGTCAGAAAGAGAGAAG	{26311}
2.7623098364064735	25081	25202	121	25081	1	1.0	GCTGTTGTTTCGATTCATACATGTTGGCTA	25172	1	1.0	GTTTCAGGCAAGTGTTGGTATCTTGAACAA	1	1.0	TCTCTATAAAAATTTTTCATTTGTTTTG	{25120}
2.7675224201679636	1200	1322	122	1200	1	1.0	CTGAGAGTTGGAGTGTTGGTGCATGGGATG	1292	1	1.0	GTTCCTGGTGATGTGATCATCACCTCAACT	1	1.0	GTTACTTATCTTCTTGTTGTGGCACACC	{1230}
2.7686857056612073	519	623	104	519	1	1.0	CCATTCCTTCTGTAGCCGTTCGCACTTATA	593	1	1.0	TTTGGCTTACAGGATTGTGTAACCGGTATT	2	1.0	AGGTTTTCAGGCATGCCGCTTTGTTGCT TCGAAGCCGCTGCACAAGGTTTTCAGGC	{565} {549}
2.7726515990016813	9884	10007	123	9884	1	1.0	GTTGTTGCCTTTTTGTATGCTGCTTTGTTG	9977	1	1.0	AATGGGCTATGGCTAATGGTTATACAAGTG	1	1.0	AATGGTTGTAGGTGGTGGTTGCGTTCAA	{9914}
2.7777	3194	3318	124	3194	1	1.0	CCTACCCATAAAGTCAAGCTCATATTTGAG	3288	1	1.0	GTGATTGGGAAGGTCTACATGAAGTTCTTA	1	1.0	GTTGTTACCAGTCTTTGTAAGAAGAGTT	{3236}
2.7777	9400	9524	124	9400	1	1.0	CATAGCACCATCAACCACTGTTCTTATTGA	9494	1	1.0	TTGGGAGTTGTTGGTGTTACAATGCATGGT	1	1.0	TGCATAATTTTTCAGTGTCTTATAATGG	{9459}
2.7777	12436	12560	124	12436	1	1.0	CACCCTAGTATGGATGGTTACTGTAAGTTT	12530	1	1.0	ATGTGTGTAATGTTTGTGGTTGTTGGTTGG	1	1.0	GTAAATGTGTTCAGGTTCCTATTGGTTG	{12470}
2.7777	23459	23583	124	23459	1	1.0	TGTTGCTGATGCTGAACGTATGGCCATGTA	23553	1	1.0	TCTTTGGCACTGCAAGCACGACTTAACTAT	1	1.0	TACAGGTTCTCTTATAGGTGGCATGGTG	{23489}
2.782670128054922	11628	11753	125	11628	1	1.0	GTCAGTTATACCTGCAACTTCAGCTTCCAA	11723	1	1.0	ATGCTGGAGTTGTTTGGACACTTAATGATG	1	1.0	TCTAAGATTGTTTGTGATGGTTCTGTTT	{11692}
2.782670128054922	26018	26143	125	26018	1	1.0	GAAACTAATGCAATCATCTCTCTCCAGGTT	26113	1	1.0	TGGTGTACTTCTTGTTGATGGCCATAAGAT	1	1.0	TACGGACATAATTATTACTTACCGGTGA	{26048}
2.7875643733214486	17097	17223	126	17097	1	1.0	GTTGCTATAACACGTGCTAAGAAGGGTATA	17193	1	1.0	TTACACTCTAGCCAGGTTTGTGGCTTGTTT	1	1.0	TCACTTAAGTTTTTTGAGATTAAACATG	{17160}
2.801814134296109	1003	1132	129	1003	1	1.0	AGGTCATACTTTGAAGTCTGGTTGCAAACT	1102	1	1.0	GGCGTTTGGTTCACCATTTATTACAAATGG	1	1.0	TTTTGAGTGGTGAATGGAATGCTGTGTA	{1071}
2.801814134296109	7830	7959	129	7830	1	1.0	CAAAACAGGGTGCTGGTTTTAAACGTACTT	7929	1	1.0	CAACCACTGTAACTAGCTTTCATGGTTATG	1	1.0	CTGTGGTATGTATGTTTATTTGTTGTTG	{7868}
2.8064266863651715	710	840	130	710	1	1.0	CGAGGTTGGCTCATTTTTTCTAACAGCAAT	810	1	1.0	TGTGTGGTTTTGATGGTAAACCTGTGTTAC	1	1.0	TTGATGTTGTTTTTGGCCATGGTGCAGG	{756}
2.8064266863651715	27445	27575	130	27445	1	1.0	CATTGGCTGATGATGATTCAGCCATTATAG	27545	1	1.0	ACCCCATGCGTTTAGCGCATGATAAGGGTT	1	1.0	CAACGAGGTTTTGCATTAAATTGTTTTG	{27482}
2.8109738099539405	23773	23904	131	23773	1	1.0	CTCTTAACCATCTCACTTCACAATTGAGAC	23874	1	1.0	CAAGTTGACAGATTAATTACTGGACGGCTT	1	1.0	ATGCTATTTATGACCGGCTTGATTCAAT	{23833}
2.8109738099539405	25668	25799	131	25668	1	1.0	ACTAAACGATGTCTAATAGTAGTGTGCCTC	25769	1	1.0	GTGTTGCAGTATGGGCATTATAAGTATAGC	1	1.0	TTTCAGAGGTTTATGTCCATTTACGTAA	{25698}
2.8109738099539405	27321	27452	131	27321	1	1.0	CTTCCTAAGTTCATTGAGCAGATTAGTGCT	27422	1	1.0	TGCTTCTATTCCAGAATCTAAACCATTGGC	1	1.0	AACCCAGTTCTGTCAAAGAAATGCAGTC	{27358}
2.8154573353204815	26316	26448	132	26316	1	1.0	GTGTTTTGTCAGAAAGAGAGAAGTTGCTTC	26418	1	1.0	CCTCCTTCATTTTACATGCCTCTTTTGGTT	1	1.0	GTGTAAATTGGGCCGATGACAGAGCTGC	{26374}
2.8285435130281846	953	1088	135	953	1	1.0	GAACAGCAAAATGTTTTAGCCATTGAGAGC	1058	1	1.0	TCTTCTAAGGTTGTTTTGAGTGGTGAATGG	1	1.0	TCTTGGTACTACAGGTCATACTTTGAAG	{991}
2.8327894934871645	480	616	136	480	1	1.0	CTGTTGCAAGTGATTCGGAAATTTCAGGTT	586	1	1.0	TGTTGCTTTTGGCTTACAGGATTGTGTAAC	1	1.0	TTGGTTTTGCCATTCCTTCTGTAGCCGT	{510}
2.8327894934871645	14507	14643	136	14507	1	1.0	TGGGCTCTAAGCATGTTAATTGTTGTACTG	14613	1	1.0	TTTATTTTAAGCCAGGTGGTACGACTTCTG	1	1.0	CAACAGATAGGTTTTATAGGCTTGGTAA	{14537}
2.8327894934871645	25712	25848	136	25712	1	1.0	GTCCATTTACGTAACTGGAACTTTAGTTGG	25818	1	1.0	AGATGTCTGTTTTATGGTGTTTATGGCCAC	1	1.0	GTATGGGCATTATAAGTATAGCAGACTT	{25777}
2.836979969342407	25236	25373	137	25236	1	1.0	GTGGTGACCACTATGTCGTTTTAGGTGGTG	25343	1	1.0	CGTAAGGTTGACTTGTATAATGGTGCTGTC	1	1.0	CTATTAGAGGTTCTTGTGAAAAGAACCT	{25305}
2.8411163730311917	23904	24042	138	23904	1	1.0	GCAGCTTTGAATGCATTTGTTTCCCAAGTT	24012	1	1.0	AATAGATATGGTTTTTGTGGCAATGGCACC	1	1.0	TCCAGACGCTTAGCACAGCAGAAGATTA	{23961}
2.8411163730311917	26994	27132	138	26994	1	1.0	ACTTCCACTCCTAAGAAACCTAATAAGCCT	27102	1	1.0	GTTATTCAGTGCTTTGGTCCTCGTGATTTT	1	1.0	ACCCAGGGCTGATAAGCCTTCTCAGTTG	{27032}
2.8452000822449524	597	736	139	597	1	1.0	GCTTACAGGATTGTGTAACCGGTATTAATG	706	1	1.0	TTTGCGAGGTTGGCTCATTTTTTCTAACAG	1	1.0	ATGATGATTATGTCATTGCATTGACTGG	{627}
2.849232422683972	14635	14775	140	14635	1	1.0	GACTTCTGGTGACGCTAGTACAGCTTATGC	14745	1	1.0	ATGTTAATGTTAGGGATCTACAACGACGTC	1	1.0	TTAACAGGTTGTTTAGTGTCCCATCAGA	{14706}
2.849232422683972	23276	23416	140	23276	1	1.0	TCAGAGAAACATTCATTCAAGCCGTATAGC	23386	1	1.0	CTTGTACTAAAGGTCTTTCTATTGCTGACC	1	1.0	AGGACGTAGTGCTTTGGAAGATTTGTTG	{23306}
2.8532146706409636	2902	3043	141	2902	1	1.0	CATGACTTTTCCTTGTGTTAGTTGTGTCAC	3013	1	1.0	AACTGTTTTTGTTGAACCTAAGGATGGTGG	1	1.0	TTTTTCTATGAATTTTTAGACACTTGTT	{2933}
2.8532146706409636	10022	10163	141	10022	1	1.0	GCTATTCTATTTTGGCAGCAAAAACTGGTG	10133	1	1.0	TATGTGATGAGTTCACACTAGCTGAAGTTG	1	1.0	AGTGTTGAACAATTGTTAGCTTCCATTC	{10054}
2.8610337616452868	13805	13948	143	13805	1	1.0	GTTTGACAAATCAAGTTGTTAAGCCAGGTC	13918	1	1.0	TTCGCACAGAATGGTGATGCTGCTGTTAAA	1	1.0	TGAAGAGTTTTATAACTTTCTTCGTTTA	{13842}
2.8648729313414405	11096	11240	144	11096	1	1.0	CAGCTAATTCTAGTGAATGGGCTTATTGTG	11210	1	1.0	GTAAACATAGTGATTTTGGTCTTGATGGCC	1	1.0	TCAAGGTATGTTGTTAGCACTCCTTGCG	{11172}
2.8648729313414405	11892	12036	144	11892	1	1.0	GCAAAAACCTATGAAAGCTGAGGGTGATGG	12006	1	1.0	CCTTAAATTTGTTAAGTGGGAGTATGAGGG	1	1.0	TGGTGTTTTAGGTGATGGTAATGCCTTG	{11922}
2.8648729313414405	26080	26224	144	26080	1	1.0	TGCACCTACAGGTGTTACATTAACACTTCT	26194	1	1.0	ACCTAGTACCACAATTGTTTGTGACCGTGT	1	1.0	TAGTGGTGTACTTCTTGTTGATGGCCAT	{26110}
2.8724160284948064	3863	4009	146	3863	1	1.0	GGTAAAAAGTTTGATGAGCAGGTTGGTTGT	3979	1	1.0	TATGAAAGGTACTGGTGTGTTTGTACAGGA	1	1.0	CACAAAACTTTTTCAAAAAGGTGAGTGT	{3913}
2.876122044777587	13606	13753	147	13606	1	1.0	GTTCCACTTGTTACAACTGCTGGTTATCAT	13723	1	1.0	GACCCTTCCTTGATAATAGCTTCTTCCCCA	1	1.0	AAAGATGTTAACACGCACTCAGTTAGGT	{13663}
2.876122044777587	13922	14069	147	13922	1	1.0	CACAGAATGGTGATGCTGCTGTTAAAGATT	14039	1	1.0	TTTATGAAGGTGGCTGTATTAAGGCATGTG	1	1.0	GTCAAGCTAGAGTTACATATAAGATAGT	{13994}
2.8797857056612073	24080	24228	148	24080	1	1.0	GCTTTTTCTTCATACTGTTTTGCTGCCAAC	24198	1	1.0	TCTGATAATGGTGTCTTTCGTGTAACTTCC	1	1.0	GCTATGTTCTGCGTCAACCTAACTTGGT	{24163}
2.8797857056612073	25842	25990	148	25842	1	1.0	GGCCACTTGTTCTAGCTTTGTCTATTTTTG	25960	1	1.0	TTTTGTTAATAGTTTCAGACTTTGGCGCCG	1	1.0	TTTTAATGTGGACTGGGTCTTTTTTGGT	{25885}
2.8834079683607334	9496	9645	149	9496	1	1.0	GGGAGTTGTTGGTGTTACAATGCATGGTTC	9615	1	1.0	TAGCATGTTATGAAGGTATTGCATCTGGTG	1	1.0	TGTGTTGCGTATTAAGGTTTCACAATCT	{9526}
2.8869897580044537	3328	3478	150	3328	1	1.0	GAATGTCATTGGGCAACATATTAAGTTGCC	3448	1	1.0	TTGTGTTGTTGAAGCGAGCACTGATTTTCA	1	1.0	GTTATGATGTTTCTAAACCAGTTATGAT	{3387}
2.8869897580044537	3648	3798	150	3648	1	1.0	GTACCACACTTGTACAGTTGCAACTTACAA	3768	1	1.0	TTAGTGGTTCACTTGGTGATAGTGGTAAAC	1	1.0	TTTGGATGATTCTATTGAGATGCAATTG	{3682}
2.8869897580044537	9928	10078	150	9928	1	1.0	GTGGTTGCGTTCAACTAGAGTTAATGTTGA	10048	1	1.0	GGTGTTAGTGTTGAACAATTGTTAGCTTCC	1	1.0	TACAATTGTTTCTAGTGTTGAGTGCTAT	{9999}
2.8940354666358683	779	931	152	779	1	1.0	GCAGGAAGTGTGGTTTTTGTGGATAAGTAT	901	1	1.0	TGGTGTCACTTATCAACTAGCATGGGATGT	1	1.0	TGTGTTACCTAAAAACATGTGGGAATTT	{832}
2.8940354666358683	23152	23304	152	23152	1	1.0	CCTTACGACTTAGTGCTCATTTGGAAACTA	23274	1	1.0	CCTCAGAGAAACATTCATTCAAGCCGTATA	1	1.0	TGTTAGTAGTATGCTAACTTTCGATAGC	{23186}
2.8975010878282044	1200	1353	153	1200	1	1.0	CTGAGAGTTGGAGTGTTGGTGCATGGGATG	1323	1	1.0	GTGCTGGTTGTGGTGTTAAATACTATGCTG	1	1.0	GTTACTTATCTTCTTGTTGTGGCACACC	{1230}
2.8975010878282044	5648	5801	153	5648	1	1.0	GCTGAAGAGGCATTATCTAAATTGTCAGAG	5771	1	1.0	TGTGCTAGTGTGCTTAAAGATGGTTGTGAT	1	1.0	GATTCTATTGTTACTCTTGAACAATATT	{5690}
2.900929642842771	3194	3348	154	3194	1	1.0	CCTACCCATAAAGTCAAGCTCATATTTGAG	3318	1	1.0	CATCTGCAATGAATGTCATTGGGCAACATA	1	1.0	GTTGTTACCAGTCTTTGTAAGAAGAGTT	{3236}
2.9043219161711367	8480	8635	155	8480	1	1.0	CGTGACTCACATAAAGGTGTTTGTTTTGGT	8605	1	1.0	TAGTTCATCTTTTAGCGTTGTGGCTATGTC	1	1.0	GTGGTGATGGTCTTATAGACCTTCTTGT	{8559}
2.9043219161711367	26018	26173	155	26018	1	1.0	GAAACTAATGCAATCATCTCTCTCCAGGTT	26143	1	1.0	TGCTACTCGTGTTCAAGTGGGTCAGTTGCC	1	1.0	TACGGACATAATTATTACTTACCGGTGA	{26048}
2.9043219161711367	26525	26680	155	26525	1	1.0	TGGTTATTGGAATGTTCAAGAGCGTTGGCG	26650	1	1.0	CTGATGGTGTTGTTTGGGTTGCTAAGGAAG	1	1.0	TATGCGCAGGGGGCAACGTGTTGATTTG	{26555}
2.907678667660241	9701	9857	156	9701	1	1.0	GCTTGTGGTTCTCCTGGTTATAATGTTAGA	9827	1	1.0	TTTGATGACCAACCTAGTTTGCAAGTTGAG	1	1.0	ATGTTGGTTCTGATTTTACTGGTAGTGT	{9789}
2.907678667660241	13676	13832	156	13676	1	1.0	CACACTCAGTTAGGTTGACAATTACTGAAC	13802	1	1.0	CTGGTTTGACAAATCAAGTTGTTAAGCCAG	1	1.0	CCTTCCTTGATAATATCTTCTTCCCCAG	{13726}
2.9142885273623995	825	983	158	825	1	1.0	GTAAACCTGTGTTACCTAAAAACATGTGGG	953	1	1.0	GAACAGCAAAATGTTTTAGCCATTGAGAGC	1	1.0	TGTCACTTATCAATTAGCATGGGATGTT	{904}
2.9142885273623995	26619	26777	158	26619	1	1.0	CCTCATAAGGACCTTAAATTCAGACAACGT	26747	1	1.0	CTCTATTGCTTTGCCTCCAGAGCTCTCTGT	1	1.0	GTAATCAGAAACCTTTGGAACCAAAGTT	{26719}
2.920764845367944	8048	8208	160	8048	1	1.0	CATGAGGCTAAGTTTGGTGTTGTTACTACT	8178	1	1.0	TTACATTACAGGCTGCTTTTGGAAACACAG	1	1.0	CTATAGTTGTTGGTGTTTCAGAGCGTGT	{8094}
2.920764845367944	27445	27605	160	27445	1	1.0	CATTGGCTGATGATGATTCAGCCATTATAG	27575	1	1.0	TAGTCTTACACACAATGGTAGGCCAGTGAT	1	1.0	CAACGAGGTTTTGCATTAAATTGTTTTG	{27482}
