cost	target-start	target-end	target-length	left-primer-start	left-primer-num-primers	left-primer-frac-bound	left-primer-target-sequences	right-primer-start	right-primer-num-primers	right-primer-frac-bound	right-primer-target-sequences	num-guides	total-frac-bound-by-guides	guide-target-sequences	guide-target-sequence-positions
3.084923285568201	12293	12471	178	12293	1	1.0	TTCTGGTAGTGGTCAGGCTATTACTAGTAC	12441	1	1.0	CAAGTGCCTATAGGTACAAATGACCCTATA	2	1.0	GTTTTTGTCAGTACAAAGGTAAGTGGGT TTTTTGTCAGTATAAAGGCAAGTGGGTA	{12412} {12413}
3.2904942636811993	26681	26769	88	26681	1	1.0	GTTTCAGACTTTTCCGACGTGCTCGAACTT	26739	2	1.0	AATCACAGTCACAACCGTGCTGGGACAGAC AATCACTGTCACAACCGTGTTGGGACAGAC	2	1.0	TTTGGGCATGGAACCCGGAAGTGAATGC TTTGGGCATGGAATCCTGAGGTTAATGC	{26711} {26711}
3.323122420167963	12380	12471	91	12380	2	1.0	CAGAGCACATGTTGCACATCCAACCATGGA CAGGGCACATGTGGCACACCCAACTATGGA	12441	1	1.0	CAAGTGCCTATAGGTACAAATGACCCTATA	2	1.0	GTTTTTGTCAGTACAAAGGTAAGTGGGT TTTTTGTCAGTATAAAGGCAAGTGGGTA	{12412} {12413}
3.6888006335339796	5746	5903	157	5746	2	1.0	AACGTGACGGTGTGCAAGTTGGTTACTGTG AACGTGATGGTGTGCAAGTTGGTTATTGTG	5873	1	1.0	TTTGAGTGGTGTTGCTTACACTGCTTTTTC	2	1.0	ACCATGGTGTTAAGTATTACTCACGAGT CCCATGGTATTAAGTACTATTCACGTGT	{5776} {5776}
3.817675799801318	11243	11448	205	11243	2	1.0	CGCATCATCTTTTGTTGGTATGCCGTCTTT TGCATCGTCTTTTGTTGGTATGCCATCTTT	11418	1	1.0	AGAATGGCTGAACAAGCTGCTGCAGCTATG	2	1.0	TGCTAAGGCTGAGTTTGACAGAGAGTCG TGTGGCATACGAAACAGCAAGACAAGAG	{11369} {11273}
3.881601953228442	12293	12530	237	12293	1	1.0	TTCTGGTAGTGGTCAGGCTATTACTAGTAC	12500	2	1.0	AGTCTGTGGTTGCTGGCTCAATCATGGTTG AGTTTGTGGTTGTTGGCTTAATCATGGCTG	2	1.0	GTTTTTGTCAGTACAAAGGTAAGTGGGT TCAGTATAAAGGCAAGTGGGTACAAGTG	{12412} {12419}
3.8834079683607334	12233	12471	238	12233	2	1.0	TGATGCTGTTAAACAAGGCGCAAAACCTGT TGATGCTGTTAGACAAGGTGCAAAACCCGT	12441	1	1.0	CAAGTGCCTATAGGTACAAATGACCCTATA	2	1.0	GTTTTTGTCAGTACAAAGGTAAGTGGGT TTTTTGTCAGTATAAAGGCAAGTGGGTA	{12412} {12413}
3.9721337616452863	26988	27214	226	26988	1	1.0	AAAACACGGTGACTTTTCTGCAGTGAGCTC	27184	2	1.0	CTTGGAAAGTGATACCACGTGACTTGGTAC CTTGGAAGGTGATACCTCGTAATTTGGTAC	3	1.0	ACAGAGCAATATGACAGAAAATGAAAGA ACGTGGTCGTCAGGGCAGAATACCTTAT GTTAATTGGGCTGATGCGTCTGAACCAC	{27021} {27119} {27090}
3.9981897580044534	233	338	105	233	1	1.0	TCTGTCTCGTGTTTGTGTGGAAGCAAAGTT	308	3	1.0	TGTGACACTTGCCGTAGCAAGTGATACTGA TGTGACACTTGCTGTTGCAAGTGATACTGA TTTTACACTTGCCGTTGCAAGTGATTCTGA	1	1.0	GGTAACTGTTCCTAATGGCCTGCAACCG	{280}
4.234329642842771	26751	26858	107	26751	2	1.0	AACCGTGCTGGGACAGACGTACTACCAACC AACCGTGTTGGGACAGACATACTATCAACC	26828	2	1.0	TGCTTTACGTGGACGGACATAGATTGGCTT TTCTTTACGTGGACGGCCATAGAATCGCTT	3	1.0	CAGGCATCACGGTGACCTTGCTGAGCGG CAGGCATTACGGTGACCTTGTTGAGCGG GGGATCACAGTAACCCTGTTGAGCGGTG	{26798} {26798} {26800}
4.312611090344213	26894	27014	120	26894	3	1.0	CAGTTGCCGTGCCGAGCACTACTATAATTT CAGTTGCCGTGCCTAGTACTACTATAATTT CGGTTGCCGTGCCGAGCACTACTATTATTT	26984	1	1.0	GAGTAAAACACGGTGACTTTTCTGCAGTGA	3	1.0	AGTAGAGTCGGAAGGTCCGTAAATTCTC GTAGAGTCGGAAGGTCCGTAAATTCACG GTAGGGTCGGGAGGTCTGTCAATTCACG	{26926} {26927} {26927}
4.358788527362399	12380	12538	158	12380	2	1.0	CAGAGCACATGTTGCACATCCAACCATGGA CAGGGCACATGTGGCACACCCAACTATGGA	12508	2	1.0	GTTGCTGGCTCAATCATGGTTGTACTTGTG GTTGTTGGCTTAATCATGGCTGTACATGTG	2	1.0	GTTTTTGTCAGTACAAAGGTAAGTGGGT TCAGTATAAAGGCAAGTGGGTACAAGTG	{12412} {12419}
4.371057335320482	281	413	132	281	1	1.0	GTAACTGTTCCTAATGGCCTGCAACCGTGT	383	3	1.0	CTATAGCGAGGCCGCTAGCAATGGATTTAG TTATAGCGAGGCCGCTAGCAATGGTTTTAG TTATAGCGAGGCCGCTGTCAATGGTTTTAG	3	1.0	AAGTGATACTGAAATTTCTGCATCTGGT CGTAGCAAGTGATACTGAAATTTCTGCA GATTCTGAAATTTCTGGAACTGGCTGTG	{326} {320} {330}
4.3778377053709505	25275	25439	164	25275	2	1.0	CAAGTGGCCGTGGTGGGTGTGGTTGTGCAT TAAGTGGCCATGGTGGGTGTGGTTGTGTAT	25409	2	1.0	GCGAATCAACTAAACTTCCTTATTACGACG GTGAGTCAACTAAACTTCCTTATTACGACG	2	1.0	GTCGTGCTCATCTTTGTGGTGAGTATGT TGTGGCTGTTGTAGTTGTTTATCGTCGT	{25309} {25366}
4.392890556965432	16626	16795	169	16626	1	1.0	GTGCTATAGGACCTGATGTCTTTTTACACA	16765	3	1.0	ACGCGGTAGTGTTCAGGTAGACAATGGCTC ACGTGGTAGTGTACAGGTGGACAATGGTTC ACGTGGTAGTGTGCAGGTAGATAATGGTTC	2	1.0	CCAGTCAAAGAGGCCAGTAAGCAGTGCT GTTTGTACCTGTCAAAGAAGCTAGTAAG	{16724} {16717}
4.408814670640964	7658	7799	141	7658	1	1.0	GGATTTTAACAGTCTTTCTGCTGAAGGTCG	7769	3	1.0	ACCTGCAACCAGCATTGTTGCTAAACAAGG ACCTGCAACTAGCATTGTTGCTAAGCAAGG ACCTGCTACTAGCATCTTATCTAAACAAGG	3	1.0	CTAAGGGCTTGACTTTCTTGTTGACAAT TGTTAACACTTAATGAAAATCAAGCTGT TTGCTGACTGTTAATGAAAATCAAGCTG	{7714} {7732} {7731}
4.429009836406473	13099	13281	182	13099	3	1.0	ATGTGTTGCGCTTTGTGACGAAATGGTTCG GTGTGTTGCTCTTTGCGACGAAATGGTGCT GTGTGTTGCTTTTTGCGATGAAATGGTGCT	13251	1	1.0	CTTATATGATGCCTGTTATGGGTATGACCA	2	1.0	GTGTCCTCCTGGAATGGGAATACCCTAC TGACTTTGGGGACTTCGTTTTGTGTCCT	{13207} {13186}
4.469888527362399	5881	6039	158	5881	1	1.0	GTGTTGCTTACACTGCTTTTTCTGGACCTG	6009	3	1.0	TCAGTTGTTATGGTAGGGGGTTATGTGGCT TCAGTTGTTATGGTGGGAGGCTATGTCGCA TCAGTTGTTATGGTTGGTGGTTATGTTGCA	3	1.0	ACTGTTTATGACACCGCAAAGAAGTCAA TGTTTATGATGCTGCTAAAAAGTCAATG TTTATGATACTGCAAAGAAATCAATGTA	{5928} {5930} {5932}
4.4731266863651715	14389	14589	200	14389	2	1.0	GGACTATCCCAAGTGTGATAGGGCTATGCC GGACTATCCTAAGTGTGATAGAGCTATGCC	14559	2	1.0	ATTTTAAACCCGGTGGTACAACTTCAGGTG ATTTTAAACCTGGTGGTACAACTTCTGGTG	2	1.0	GGCTAGTGATAAATTTTATAGACTTAGT TCAATGATTCGTATGCTGTCGGCCATGA	{14479} {14420}
4.485840417140111	281	444	163	281	1	1.0	GTAACTGTTCCTAATGGCCTGCAACCGTGT	414	3	1.0	GCATGCCGATTTGTTTCATTAGATTTGCAG GCATGCCGATTTGTTTCATTTGGCTTGCAT GCATGCCGATTTGTTTCATTTGGTTTGCAA	3	1.0	AAGTGATACTGAAATTTCTGCATCTGGT CGTAGCAAGTGATACTGAAATTTCTGCA GATTCTGAAATTTCTGGAACTGGCTGTG	{326} {320} {330}
4.511900082244952	12380	12598	218	12380	2	1.0	CAGAGCACATGTTGCACATCCAACCATGGA CAGGGCACATGTGGCACACCCAACTATGGA	12568	2	1.0	GTTATTTAAACGAGTCAGGGGCTCTAGTGC GTTATTTAAACGAGTCCGGGGTTCTAGTGC	2	1.0	GTTTTTGTCAGTACAAAGGTAAGTGGGT TCAGTATAAAGGCAAGTGGGTACAAGTG	{12412} {12419}
4.55723196905215	13039	13281	242	13039	3	1.0	TGAGGACATACACCGCGTGTACGCTGCTTT TGAGGACATACACCGTGTATACGCTGCTTT TGAGGACATACACCGTGTGTATGCTGCTTT	13251	1	1.0	CTTATATGATGCCTGTTATGGGTATGACCA	2	1.0	CAAAGTAGTCGCAAATGCAATGATTAAA TGTTGCTCTTTGCGACGAAATGGTGCTT	{13072} {13102}
4.5624729605267245	9769	10014	245	9769	1	1.0	GCTTTGATGGTGTTATGTATGGTGGTTTTG	9984	3	1.0	TTCTCCATTCTTGCTGCTAAAACTGGCGTT TTTTCCATTCTTGCTGCTAAAACTGGTGTC TTTTCTATTCTTGCTGCAAAAACCGGTGTC	2	1.0	ACATGGTGGCTTAAAGGCGACAAATTGT ACCAGATGCTAACAGTTAATGTGGTCGC	{9891} {9832}
4.567629642842771	12380	12628	248	12380	2	1.0	CAGAGCACATGTTGCACATCCAACCATGGA CAGGGCACATGTGGCACACCCAACTATGGA	12598	2	1.0	CGCTCGACTAGAACCCTGTAATGGTACAGA CGCTCGACTAGAGCCCTGCAATGGTACAGA	2	1.0	GTTTTTGTCAGTACAAAGGTAAGTGGGT TCAGTATAAAGGCAAGTGGGTACAAGTG	{12412} {12419}
4.846094263681199	17140	17256	116	17140	1	1.0	TGGTTTGTTTAAAGATTGTGCACGTAACCC	17226	4	1.0	AAACTAGTGGCGATTTGGCTGTCCAAATAG AGACTAGTGGTGACTTAGCTGTCCAGATAG AGACTAGTGGTGACTTGGCTGTTCAAATAG AGACTAGTGGTGATTTAGCTGTTCAGATAG	2	1.0	ACTACTTATCTATCATTGTCTGATAGAT AGCCATGCCACTACGTATTTGTCACTTT	{17195} {17186}
4.92217380995394	13150	13281	131	13150	4	1.0	AACTCTAGACAACCAGGATCTTAATGGGAA GACCCTCGATAATCAGGATCTCAATGGGAA GACCTTAGACAACCAAGATCTTAATGGGAA GACCTTAGATAACCAAGACCTTAATGGGAA	13251	1	1.0	CTTATATGATGCCTGTTATGGGTATGACCA	2	1.0	GTGTCCTCCTGGAATGGGAATACCCTAC TGACTTTGGGGACTTCGTTTTGTGTCCT	{13207} {13186}
4.976072931341441	12910	13054	144	12910	3	1.0	GGACTTGTGCTTTGCTCTGCGTAACTTTGA GGATTTGTGCTTCGCTCTGCGTAACTTTGA GGATTTGTGTTTTGCCCTGCGTAATTTTGA	13024	2	1.0	TGACCCAGTAGAAAATGAGGACATACACCG TGACCCCATAGAAAATGAGGACATACACCG	2	1.0	CTGATTACTTTGAAATGAAGAATTGGTT TTCTTACTGGTTGTTGTGGTACCGATTA	{12996} {12975}
4.976072931341441	14380	14482	102	14380	2	1.0	GATGGGATGGGACTATCCTAAGTGCGATAG GATGGGCTGGGACTATCCTAAGTGTGATAG	14452	3	1.0	AGGTTCAAAGCACGTCACATGTTGTACGGC AGGTTCTAAACATGTTACATGTTGTACGGC AGGTTCTAAGCATGTCACATGTTGTACGGC	4	1.0	ATGCCTTCAATGATACGCATGTTGTCAG GCTATGCCTTCAATGATTCGAATGTTGT TCAATGATTCGTATGCTGTCGGCCATGA TGCCTTCAATGATTCGTATGTTATCAGC	{14414} {14411} {14420} {14415}
5.0	12643	12831	188	12643	2	1.0	CCGTGCATTTGACGTTTACAACAAAGACGC CCGTGCATTTGACGTTTACAATAAAGATGC	12801	3	1.0	TACTTAAAAACTGCGATGCTGTCGCAAAGC TACTTAAAGGCTGTAATGCTATTGCCAAGC TACTTAAAGGCTGTAATGCTGTTGCTAAGC	1	1.0	CTTGAAGTCCAATTGTGTGCGCTTCAAG	{12691}
5.0052354666358685	5797	5903	106	5797	4	1.0	CACGAGTCAGGAGTGTTAGTGGGCGTGCCA CACGTGTTAAAAGTGTTAGAGGTAGAGCTA CACGTGTTAAGAGTGTCAGTGGTAGAGCCA CACGTGTTAGAAGTGTTAGCGGTAGAGCTA	5873	1	1.0	TTTGAGTGGTGTTGCTTACACTGCTTTTTC	4	1.0	TATAGTCAGTGTCGAACAGCTTGAACCG TCATAGTAGGTGTTGAACAAATTGAACC TCATAGTTAGTGTAGAGCGTCTTGAACC TTATATTCAGTGTCGAACAGCTTGAACC	{5828} {5827} {5827} {5827}
5.012129642842771	16773	16927	154	16773	3	1.0	GTGTACAGGTGGACAATGGTTCCAGTATAA GTGTGCAGGTAGATAATGGTTCCAGTATAA GTGTTCAGGTAGACAATGGCTCCAGTATAA	16897	2	1.0	TGTAGCTGCTAGGCTTTTAGGTTTACAAAC TGTCGCTGCTAGACTTTTGGGTTTGCAAAC	2	1.0	CGTCGACAACTTGACGTCGTCAAGCGTT GCGATTTATACATAAAAACCCTACATGG	{16805} {16828}
5.028726686365172	9769	9899	130	9769	1	1.0	GCTTTGATGGTGTTATGTATGGTGGTTTTG	9869	4	1.0	TGCGGCTATATTGAATGGTTGCACCTGGTG TGCTGCCATACTGAATGGTTGTACATGGTG TGCTGCTATATTGAATGGTTGCACATGGTG TGCTGCTATATTGAATGGTTGCATATGGTG	3	1.0	AACCAGATGCTAACAGTCAATGTGGTAG ACCAGATGCTAACAGTTAATGTGGTCGC GCCTAACCTTCAAGTTGAATCTGCAAGT	{9831} {9832} {9806}
5.028743040981689	26751	26910	159	26751	2	1.0	AACCGTGCTGGGACAGACGTACTACCAACC AACCGTGTTGGGACAGACATACTATCAACC	26880	3	1.0	ACCTGAACACATGACAGTTGCCGTGCCGAG ACCTGAATACATGACAGTTGCCGTGCCGAG ACCTGAGTACATGTCGGTTGCCGTGCCGAG	2	1.0	GGGATCACAGTAACCCTGTTGAGCGGTG GTGCTTTACGTGGACGGACATAGATTGG	{26800} {26827}
5.057191578646307	7586	7799	213	7586	2	1.0	GCGCGCTGGTGCTAAGACTGTTAATGCTAA GCGTGCAGGTGCTAAGGTTGTTAATGCCAA	7769	3	1.0	ACCTGCAACCAGCATTGTTGCTAAACAAGG ACCTGCAACTAGCATTGTTGCTAAGCAAGG ACCTGCTACTAGCATCTTATCTAAACAAGG	1	1.0	TAACAGTCTGTCTGCTGAAGGTCGCAAG	{7664}
5.065419205502994	12134	12305	171	12134	4	1.0	CACTGTCAGATTGCAAGCTGGTAAACAGAC CACTGTGAGATTGCAAGCTGGCAAACAGAC TACTGTGAGATTGCAAGCTGGTAAACAGAC TACTGTTAGACTGCAGGCTGGTAAACAAAC	12275	1	1.0	AAAGATGTTGACTAATGGTTCTGGTAGTGG	2	1.0	TGAGTTTGTTTCAAATTCCCACTTACTA TGAGTTTGTTTCAAATTCCCATTTATTA	{12164} {12164}
5.1110657561098884	12639	12880	241	12639	1	1.0	GTGTCCGTGCATTTGACGTTTACAATAAAG	12850	4	1.0	TGAAGGCAGAACCATCTATGGTAACGTTAG TGAAGGCCGAACCATCTATGGTAATGTTAG TGAGGGCAGAACCATCTATGGTAATGTTAG TGAGGGCAGAACCATTTATGGTAATGTTAG	1	1.0	CTTGAAGTCCAATTGTGTGCGCTTCAAG	{12691}
5.1135946961550465	11498	11687	189	11498	2	1.0	GCATAGTTTACTCTTTGGCATGCTCCGACG GCATCGCTTACTCTTTGGCATGCTCCGTAG	11657	3	1.0	AATGATGGTAGATGGTTTTGTGCACTACGC AATGATGGTAGATGGTTTTGTTCACTACGC AATGTTGGTAGATGGTTTTGTGCACTATGC	2	1.0	GTCGTCGTGGTGCCAGATCATGATTCAT GTCGTTGTAGTACCAGATCATGATTCAT	{11622} {11622}
5.118526590941621	9056	9247	191	9056	2	1.0	CTCTCCAGAAAAGTTGAAAAGTTATGCTGC TTCGCCAGATAAGTTGAAAAGTTATGCAGC	9217	3	1.0	CAACAGTTAGTTATGGTTCGACCTTGCAAG CAACTGTCAGTTATGGGTCTACATTACAAG CAACTGTCAGTTATGGTTCTACATTACAGG	2	1.0	CCTATTTAGCGAAAGCAATGTTGGACTT TGGACTTTTCGCGTGATCATAATGACAT	{9154} {9175}
5.123383757168364	17964	18157	193	17964	2	1.0	CCGTCTATGACTGTTTTGTTAAGAATGTGG CTGTGTATGACTGCTTTGTTAAGAATGTGG	18127	3	1.0	TAAAGGTATTCGTTGTGCCGTAACAAATGC TAAGGGTATTCGTTGTGCCGTGACTGATGC TAAGGGTATTCGTTGTGCTGTAACTGATGC	2	1.0	CGTGTGGTACAGAGTCATATTATGCGCG TGCAAAGTCATATCATGCGTGCTGCTAT	{18050} {18057}
5.128168425664694	16773	16968	195	16773	3	1.0	GTGTACAGGTGGACAATGGTTCCAGTATAA GTGTGCAGGTAGATAATGGTTCCAGTATAA GTGTTCAGGTAGACAATGGCTCCAGTATAA	16938	2	1.0	ATTCTGCTCAAGGCAGTGAATATGACTATG ATTCTGCTCAAGGTAGCGAGTATGACTATG	2	1.0	CGTCGACAACTTGACGTCGTCAAGCGTT GCGATTTATACATAAAAACCCTACATGG	{16805} {16828}
5.132882728833828	25242	25439	197	25242	3	1.0	CCTTGAGTGGCTCAACCGTGTAGAAAACTA CTTAAAGTGGCTCAACCGGGTTGAGACTTA TCTTGAGTGGCTCAACCGTGTTGAGACTTA	25409	2	1.0	GCGAATCAACTAAACTTCCTTATTACGACG GTGAGTCAACTAAACTTCCTTATTACGACG	2	1.0	GTGGGTTTGGTTGTGCATTTCAGTCGCG TGTGGCTGTTGTAGTTGTTTATCGTCGT	{25287} {25366}
5.146254591467449	17572	17733	161	17572	3	1.0	AGTACCTCTGTTACGCAGGGGACAACCTTG AGTACCTCTGTTGCGTAAGGGCCAGCCGTG TGTACCTCTGTTACGCAAGGGACAACCTTG	17703	2	1.0	CCACCATGCGTTATTTTGTAAAGATAGGCT CCACTATGCGTTATTTTGTCAAGATTGGAG	3	1.0	GAGTGTGTTGAGAAAACGTATTGTTCAA GAGTGTGTTGAGAAAGCGCATTGTCCAA TTGCTGGCTCATCTGATGTATTGGTGTT	{17602} {17602} {17646}
5.15327901698314	9776	9982	206	9776	2	1.0	TGGTGTTATGTATGGCGGTTTTGATGACCA TGGTGTTATGTATGGTGGTTTTGAAGACCA	9952	3	1.0	ATGGTTTCACAGCTATGAATGGTGAAGACG ATGGTTTTACAGCCATGAATGGTGAAGATG ATGGTTTTACAGCTATGAATGGCGAAGATG	2	1.0	ACATGGTGGCTTAAAGGCGACAAATTGT ACCAGATGCTAACAGTTAATGTGGTCGC	{9891} {9832}
5.159799245246692	16626	16835	209	16626	1	1.0	GTGCTATAGGACCTGATGTCTTTTTACACA	16805	4	1.0	AGACGCCAACTTGATGTTGTTAAGCGATTT AGGCGCCAACTCGATGTTGTCAAGCGATTT AGGCGTCAACTTGATGTTGTTAAGCGATTT CGTCGACAACTTGACGTCGTCAAGCGTTTT	2	1.0	CCAGTCAAAGAGGCCAGTAAGCAGTGCT GTTTGTACCTGTCAAAGAAGCTAGTAAG	{16724} {16717}
5.166189493487164	13024	13236	212	13024	2	1.0	TGACCCAGTAGAAAATGAGGACATACACCG TGACCCCATAGAAAATGAGGACATACACCG	13206	3	1.0	TGTGTCCGCCTGGAATGGGAATACCTTATT TGTGTCCTCCTGGAATGGGAATACCCTACT TGTGTCCTCCTGGTATGGGAATACCCTATT	2	1.0	CAAAGTAGTCGCAAATGCAATGATTAAA TGTTGCTCTTTGCGACGAAATGGTGCTT	{13072} {13102}
5.188587395870145	19084	19307	223	19084	2	1.0	CTCTGCTACTGCTGTGAAAGCAGGTGGTAA CTCTGTTACTGCTGTTAAAACAGGTGGTAA	19277	3	1.0	AACCTCCAAGACTTTTTACCGCGTAGCACA AACTTACAAGACTTTTTGCCCCGTAGCACA AATTTACAAGACTTTTTGCCTCGCAGCACA	2	1.0	ATTTGCCAGCCATTCGGTTAAATTTTGG TTGCCGGCTATTAAATTGAATTTTGGAA	{19116} {19118}
5.1944337616452865	16556	16782	226	16556	2	1.0	GCCCCTAGGGTGCTTATATCCAAAGGAACT GCTCCTAGAGTTCTTATCTCTAAAGGTGTT	16752	3	1.0	TCAAAATCTTTGAACGCGGTAGTGTTCAGG TCAAAATCTTTGAACGTGGTAGTGTGCAGG TTAAGATCTTTGAACGTGGTAGTGTACAGG	2	1.0	CCAGTCAAAGAGGCCAGTAAGCAGTGCT GTTTGTACCTGTCAAAGAAGCTAGTAAG	{16724} {16717}
5.200175410741902	16773	17002	229	16773	3	1.0	GTGTACAGGTGGACAATGGTTCCAGTATAA GTGTGCAGGTAGATAATGGTTCCAGTATAA GTGTTCAGGTAGACAATGGCTCCAGTATAA	16972	2	1.0	ATTCGCACAGACATCAGATACTGCTCATGC ATTTGCACAAACATCAGATACTGCTCATGC	2	1.0	CGTCGACAACTTGACGTCGTCAAGCGTT GCGATTTATACATAAAAACCCTACATGG	{16805} {16828}
5.201511090344213	26590	26710	120	26590	4	1.0	GCAAACTGGGGATCCAACTGGGCCTTTGTC GCAAATTGGGGAACCAATTGGGCCTTTGTT GCTAACTGGAATGAGAACTGGGCCTTTGTT GCTAATTGGGACTCTAATTGGGCCTTTGTT	26680	1	1.0	AGTTTCAGACTTTTCCGACGTGCTCGAACT	5	1.0	AAGCCTTTTTATGGCCATAGCCACACTT GCACTCAGCCTTTTTATGGCCGTATCAA GCATTCAGCCTTTTTATGGCCGTATCAA GCATTTAGCTTCCTTATGGCCGTATCAA TTTTATGGCTATAGCCACATTTGTTATG	{26625} {26620} {26620} {26620} {26631}
5.202066666009797	281	511	230	281	1	1.0	GTAACTGTTCCTAATGGCCTGCAACCGTGT	481	4	1.0	TGGGTCTGACCGGCGACCAACCACTGGTTT TGGGTCTGCATGGCAATCAGACGTTGTTTT TGGGTCTGCATGGTAACCAAACGTTGTTCT TGGGTTTGCATGGTAACCAAACGTTGTCCT	2	1.0	CAATGGATTTAGAGCATGCCGATTTGTC CGTAGCAAGTGATACTGAAATTTCTGCA	{401} {320}
5.227435466635868	8996	9240	244	8996	3	1.0	TGCTGCAGCTGGTACATTTGTGATTGACAT TGCTGCTGCAGGAACATTTGTTATTGACAT TGCTGCTGCAGGTACGTTTGTTCTAGACAT	9210	2	1.0	ACACCACCAACAGTTAGTTATGGTTCGACC ACACCTCCAACTGTCAGTTATGGTTCTACA	2	1.0	CCTATTTAGCGAAAGCAATGTTGGACTT TGGACTTTTCGCGTGATCATAATGACAT	{9154} {9175}
5.241634243325826	8876	9072	196	8876	3	1.0	ATGGTGGCTGTGTGCTTGGTACTTTCTTGC ATGGTGGTTGTGTACTTGGTACTTTTTGGC GTGGTGGCTGTGCGCCTGGTACTTTTTATC	9042	2	1.0	CTTGCTAACAGCATTTCGCCAGATAAGTTG CTTGCTAATAGCATCTCTCCAGAAAAGTTG	3	1.0	ACCTAGTTTGTTGAAGCTTAAAGTCTCG CTTACGGGTTTGTTGCCAAGTTTGTTGA TTAACAGGTTTGTTACCCAGTTTGTTGA	{8924} {8910} {8910}
5.26437901698314	11065	11271	206	11065	3	1.0	CAAAGGAGTGGGCATATTGTGTTGAAACAC CAAAGGAGTGGGCATATTGTGTTGAAACGC CAAAGGAGTGGGCGTATTGTGTTGAAATGC	11241	2	1.0	GTCGCATCATCTTTTGTTGGTATGCCGTCT GTTGCATCGTCTTTTGTTGGTATGCCATCT	3	1.0	TCTTGTCTAAGCATAGTGATTTAGGTCT TGTCTAAGCATAGTGATTTTGGTCTTGG TTTTGTCTAAGCATAGTGATTTTGGACT	{11164} {11167} {11164}
5.279391578646307	11925	12138	213	11925	2	1.0	GGACGTGCATTTATGTATGCATATGTGACT GGCCGTGCATTTATGTATGCGTATGTGACC	12108	3	1.0	GGTGCTGTTTTGGGTTACATAGGCGCTACT GGTGCTGTTTTGGGTTACATTGGTGCCACT GGTGCTGTTTTGGGTTATATCGGTGCTACT	3	1.0	GTTAAATGGGAACATGAATCGGGTGTGG TCCGGCGTGGTTACAGTAGAACTAGAAC TTAAATGGGAGCATGACTCTGGTGTGGT	{11976} {11994} {11977}
5.324285705661208	19453	19689	236	19453	3	1.0	AGGTAAGATGGGCATCCTTAAAGCTGAAGA GAGTAAAATGGGCATCTTAAAGGCAGAGGA GAGTAAAATGGGCATCTTGAAGGCAGAAGA	19659	2	1.0	AACCATGGAGATGGATGCTATGGTGTAAAG AACCATGGCGATGGATGCTTTGGTGTAAAG	3	1.0	ATTGAAATCTTTAGAGTTGACTGTTGTA CTATATTGAAGTCTTTGGATTTGACCGT TGTTGCTATATTAAAATCTTTGGACCTA	{19600} {19596} {19591}
5.333265756109888	17492	17733	241	17492	3	1.0	GGTTGTGTTATAACAAACACGGGCAGTGTT GGTTGTGTTGTAACAAACACTGGTAGTGTT GGTTGTGTTTTAACAAACACTGGCAGTGTT	17703	2	1.0	CCACCATGCGTTATTTTGTAAAGATAGGCT CCACTATGCGTTATTTTGTCAAGATTGGAG	3	1.0	ACGCAAGGGACAACCGTGGAGTGTGTTG GTTACGCAGGGGACAACCTTGGAGTGTG TTGGAGTGTTTTGAGAAAACGTATTGTT	{17584} {17581} {17599}
5.333399999999999	5733	5825	92	5733	2	1.0	TGTGCTAGTGTCAAACGTGATGGTGTGCAA TGTGCTGGTGTTAAACGTGATGGTGTGCAA	5795	4	1.0	CTCACGAGTCAGGAGTGTTAGTGGGCGTGC TTCACGTGTTAAAAGTGTTAGAGGTAGAGC TTCACGTGTTAAGAGTGTCAGTGGTAGAGC TTCACGTGTTAGAAGTGTTAGCGGTAGAGC	2	1.0	GTTGGCTATTGTGACCATGGTGTTAAGT GTTGGTTATTGTGCCCATGGTATTAAGT	{5763} {5763}
5.347130266661923	11925	12174	249	11925	2	1.0	GGACGTGCATTTATGTATGCATATGTGACT GGCCGTGCATTTATGTATGCGTATGTGACC	12144	3	1.0	CTGCAGGCTGGTAAACAAACTGAGTTTGTT TTGCAAGCTGGCAAACAGACTGAGTTCGTT TTGCAAGCTGGTAAACAGACTGAGTTTGTT	3	1.0	GTTAAATGGGAACATGAATCGGGTGTGG TCCGGCGTGGTTACAGTAGAACTAGAAC TTAAATGGGAGCATGACTCTGGTGTGGT	{11976} {11994} {11977}
5.371157335320482	14322	14418	96	14322	4	1.0	ATGGCGGTTGGGACAATATGCTAAAGAACT ATGGCGGTTGGGATAATATGTTAAAGAACC ATGGTGGCTGGGATAATATGCTAAAGAATC ATGGTGGCTGGGATAATATGTTAAAGAACC	14388	2	1.0	GGGACTATCCCAAGTGTGATAGGGCTATGC GGGACTATCCTAAGTGTGATAGAGCTATGC	2	1.0	CCGATGTTGACGATCCTAAATTGATGGG CTGACGTTGACGATCCTAAGTTGATGGG	{14358} {14358}
5.371157335320482	26814	26910	96	26814	3	1.0	CCTGTTGAGCGGTGTTCTTTACGTGGACGG CTTGCTGAGCGGTGTGCTTTACGTGGACGG CTTGTTGAGCGGCGTGCTTTACGTGGACGG	26880	3	1.0	ACCTGAACACATGACAGTTGCCGTGCCGAG ACCTGAATACATGACAGTTGCCGTGCCGAG ACCTGAGTACATGTCGGTTGCCGTGCCGAG	2	1.0	ACATAGATTGGCTTCAGGTGTTCAGGTT ATCGCTTCAGGTATTCAGGTTCATAATT	{26844} {26851}
5.388489493487164	19084	19182	98	19084	2	1.0	CTCTGCTACTGCTGTGAAAGCAGGTGGTAA CTCTGTTACTGCTGTTAAAACAGGTGGTAA	19152	4	1.0	ACGGTAATGCAATTGCTACTGTCAAATCAG ATGGTAATCCTGTAGCAACAGTTAAGGCAG ATGGTAATGCCATTGCTACTGTCAAATCAG ATGGTAATGCCGTCGCTACTGTCAAATCAG	2	1.0	ATTTGCCAGCCATTCGGTTAAATTTTGG TTGCCGGCTATTAAATTGAATTTTGGAA	{19116} {19118}
5.412748055426138	9166	9390	224	9166	3	1.0	AAGCAATGCTGGATTTTTCGCGTGATCATA AAGCAATGTTGGACTTTTCGCGTGATCATA AGGCCATGATGGACTATTCGCGTGATCATA	9360	2	1.0	CCACGGCACGTTATCGCATCTAATACAACT CCACGTCATGTTATTGCATCTAACACAACT	4	1.0	ATACACACCTCCAACTGTCAGTTATGGG CGGTTCTACATTACAGGCAGGTTTGCGT TAGTTATGGTTCGACCTTGCAAGCAGGT TCAGTTACGGTTCTACATTACAGGCAGG	{9206} {9230} {9224} {9223}
5.412848055426138	12639	12740	101	12639	1	1.0	GTGTCCGTGCATTTGACGTTTACAATAAAG	12710	5	1.0	CGCTTCAAAAATGCAGATAAAGATGATGCG CGCTTCAAGAACGCAGATAAGGATGATGCG CGCTTCAAGAATGCAGATAAGGACGATGCG CGCTTCAAGAATGTAGATAAGGATGACGCG CGCTTCAGAAATGCTGATAAGGATGATGCG	2	1.0	CGGAAAAAATCTGAAGTCCAATTGTGTG TGCTTCTTTTATCGGCAAAAACTTGAAG	{12682} {12670}
5.424266666009797	18882	19112	230	18882	3	1.0	CCCTCAGTATTCTCAAAAACCTCGGTGTTG CTCTCAGTATTCTCAAAAACCTTGGTGTTG CTCTTAGCATTCTTAAGAACCTAGGTGTTG	19082	2	1.0	TTCTCTGCTACTGCTGTGAAAGCAGGTGGT TTCTCTGTTACTGCTGTTAAAACAGGTGGT	4	1.0	ACAAGTTTTACTAAGTCTGTTTGTGGTT AGAACGTCCTCTAACTAGTTTCACTAAG AGGTTCTTATGAACGTTTTACTCTGTCA TTACAAGCTTTACTAAGGCTGTTTGTGG	{18962} {18949} {19039} {18960}
5.429109836406473	26634	26755	121	26634	4	1.0	TATGGCCATAGCCACACTTGTTATGTGGGT TATGGCCGTATCAACACTCATTATGTGGGT TATGGCCGTATCAACACTCGTTATATGGGT TATGGCTATAGCCACATTTGTTATGTGGGT	26725	2	1.0	CCGGAAGTGAATGCAATCACAGTCACAACC CCTGAGGTTAATGCAATCACTGTCACAACC	1	1.0	CCGACGTGCTCGAACTTTTTGGGCATGG	{26694}
5.4518265909416215	6305	6496	191	6305	1	1.0	TAAGTGGTGGCTGCTTGCTAAGTTTATGAA	6466	4	1.0	GCGGTAATTCATTGGGCTGTAAGATGTGTC GTGAAGGTTCACTAGGTTGTAAAATGTGTC GTGATGGTTCATTGGGCTGCAAGATGTGTC GTGATGGTTCATTGGGCTGTAAAATGTGTC	5	1.0	ACTCATCTATACATTGTACTCAGTAGTT CTACTGTTACTTATATATACATTGTATT CTCATTTACACGTTGTATTCAGTAGTTT CTTGGTGTACGCTTTGGACCATTTAATG GTTTATGTTACTTGTGTACACACTGTAT	{6344} {6336} {6345} {6375} {6335}
5.499589493487164	26924	27022	98	26924	3	1.0	ATAGTAGAGTCGGAAGGTCCGTAAATTCAC ATAGTAGGGTCGGAAGGTCCGTAAATTCAC ATAGTAGGGTCGGGAGGTCTGTCAATTCAC	26992	3	1.0	CACGGTGACTTTTCTGCAGTCAGCTCACCG CACGGTGACTTTTCTGCAGTGAGCTCTCCT CACGGTGATTTTTCTGCAGTGAGCTCCCCC	3	1.0	ACAGGCTGGGTTTTCTACGTTCGAGTAA GTAACAACACAGGTTGGATGTTTTATGT TGGCTGGGTTTTCTACGTACGAGTAAAG	{26962} {26954} {26964}
5.5295232855682	16663	16782	119	16663	3	1.0	CAGATGTCCTGCTGAAATAGTTAACACTGT CAGGTGTCCAGCTGAAATAGTTAACACTGT CAGGTGTCCTGCTGAAATAGTTAATACTGT	16752	3	1.0	TCAAAATCTTTGAACGCGGTAGTGTTCAGG TCAAAATCTTTGAACGTGGTAGTGTGCAGG TTAAGATCTTTGAACGTGGTAGTGTACAGG	2	1.0	CCAGTCAAAGAGGCCAGTAAGCAGTGCT GTTTGTACCTGTCAAAGAAGCTAGTAAG	{16724} {16717}
5.545422420167963	15740	15862	122	15740	4	1.0	GAAACGGTCAAGGCTAAAGAGGAAAGTGTT GAAACTGTCAAAGCTAAGGAGGAAAGTGTT GAAACTGTCAAGGCTAAAGAAGAAAGTGTG GAGACTGTGAAAGCTAAAGAGGAAAGCGTT	15832	2	1.0	ATGGGAAAGTGGAAAAGCCAAACCACCGTT ATGGGAAAGTGGAAAAGCCAAACCGCCATT	2	1.0	ATTGTAGGTCCTAAGGAACTTTTGCTTT TTGTAGGTCCTAAGGAATTTTTGCTCTC	{15803} {15804}
5.5605701280549225	12134	12259	125	12134	4	1.0	CACTGTCAGATTGCAAGCTGGTAAACAGAC CACTGTGAGATTGCAAGCTGGCAAACAGAC TACTGTGAGATTGCAAGCTGGTAAACAGAC TACTGTTAGACTGCAGGCTGGTAAACAAAC	12229	2	1.0	ATCTTGATGCTGTTAAACAAGGCGCAAAAC ATCTTGATGCTGTTAGACAAGGTGCAAAAC	2	1.0	TGAGTTTGTTTCAAATTCCCACTTACTA TGAGTTTGTTTCAAATTCCCATTTATTA	{12164} {12164}
5.597779016983139	11671	11804	133	11671	3	1.0	GCTTTGTTCACTACGCAGGTGTTGTTTGGA GTTTTGTGCACTACGCTGGCGTTGTTTGGA GTTTTGTTCACTACGCGGGTGTTGTTTGGA	11774	3	1.0	ACTTGTCTGGCCTCTGATTTTGACATGCGA ACTTGTTTGGCCTCTGATTTTGACTTGTGA ACTTGTTTGGCCTTTGGTTTTGACATGTGA	2	1.0	CAAGAGGTTAAAGACAATGATGGTAGGA TAAAGATGTTACAAAGGAAAACCAGGAA	{11706} {11744}
5.612236002980723	6219	6333	114	6219	5	1.0	ATAGCCAGAGCGCCGCAACGCACAGGTGTT ATGGCCAAAGCACCACAAAGGACGGGTGTT ATGGCCAAAGTACCACAAAGAACGGGTGTT ATGGCTAAAGCACCACAAAGGACAGGTGTT ATGGCTAGAGCACCACAAAGAACGGGTGTT	6303	1	1.0	TCTAAGTGGTGGCTGCTTGCTAAGTTTATG	3	1.0	AATATAACTTAAAAGCGTCAACAGCTGT TATAACTTAAAAGCATCTGCAGCTGTTC TTCAAGTACAACTTAAAAGCTTCGGCAG	{6268} {6270} {6264}
5.612236002980723	26958	27126	168	26958	2	1.0	CAACACAGGTTGGATGTTTTATGTCAGAGT CAGCACAGGCTGGGTTTTCTACGTACGAGT	27096	4	1.0	TGGGCTGATGAGTCTGAGCAGCAGCGTGGT TGGGCTGATGCATCTGAACCACAACGTGGT TGGGCTGATGCTTCTGAACCACGGCGTGGT TGGGCTGATTCCTCTGAACCACAACGTGGT	1	1.0	CACGGTGACTTTTCTGCAGTGAGCTCAC	{26992}
5.623100082244952	13024	13163	139	13024	2	1.0	TGACCCAGTAGAAAATGAGGACATACACCG TGACCCCATAGAAAATGAGGACATACACCG	13133	4	1.0	GGAGTTGTTGGTGTCCTAACTCTAGACAAC GGAGTTGTTGGTGTCTTGACCTTAGATAAC GGAGTTGTTGGTGTTTTGACCTTAGACAAC GGCGTTGTTGGTGTTTTGACCCTCGATAAT	2	1.0	CAAAGTAGTCGCAAATGCAATGATTAAA TGTTGCTCTTTGCGACGAAATGGTGCTT	{13072} {13102}
5.686134243325825	25311	25439	128	25311	4	1.0	CGCGCTCATCTTTGTGGTGAGTATGTTACT CGTGCTCATCTTTGTGGTGAGTATTTTGCT TGTCCTAATTTTTACTGTGGGCTTGCTCTT TGTGTTGATTTTTGTGGTGGGCTTGCTGAT	25409	2	1.0	GCGAATCAACTAAACTTCCTTATTACGACG GTGAGTCAACTAAACTTCCTTATTACGACG	3	1.0	CTGTGGCTTCTTTAGTTGTCTTGCATCT GCTGTGGTTTCTTTAGTTGTCTTGCTTC TGTGGCTGTTGTAGTTGTTTATCGTCGT	{25365} {25364} {25366}
5.690814134296109	8876	9005	129	8876	3	1.0	ATGGTGGCTGTGTGCTTGGTACTTTCTTGC ATGGTGGTTGTGTACTTGGTACTTTTTGGC GTGGTGGCTGTGCGCCTGGTACTTTTTATC	8975	3	1.0	ATTTGTAGGTACATTTGAAAGTGCTGCTGC GTTCGTAGGCACATTTGAAAGTGCTGCTGC GTTTGTGGGTACATTCGAAAGTGCTGCAGC	3	1.0	ACCTAGTTTGTTGAAGCTTAAAGTCTCG CTTACGGGTTTGTTGCCAAGTTTGTTGA TTAACAGGTTTGTTACCCAGTTTGTTGA	{8924} {8910} {8910}
5.692188527362399	9464	9622	158	9464	2	1.0	CCTTGGCGTTGTAGGTGCTACTATGCATGG TCTTGGTGTTGTAGGTGCTACTATGCATGG	9592	4	1.0	GCTATGATGGTTGTGCCCAAGGTGTCTTTG GCTATGATGGTTGTGCTCAGGGTGTTTTTG GTTATGATGGTTGTGCACATGGTGTTTTTG GTTATGATGGTTGTGCCCAAGGTGTTTTCG	2	1.0	AAATTAAGGTGTCACAGACTAACATGCA TCTTAGAATTAAAGTCTCACAGACTAAC	{9505} {9500}
5.704457335320481	9667	9799	132	9667	5	1.0	ATGGTGCATGTGGCTCTCCTGGTTACAATC ATGGTGCATGTGGTTCCCCTGGCTATAATC ATGGTGCATGTGGTTCTCCTGGCTATAATC ATGGTGCGTGTGGTTCCCCTGGCTATAACC ATGGTGCGTGTGGTTCTCCTGGCTACAATC	9769	1	1.0	GCTTTGATGGTGTTATGTATGGTGGTTTTG	3	1.0	GCATCAAATTGAACTCGGAAGTGGTAGT TGGCGAGGTGGAATTTGTTTATATGCAT TTAGAGGTAGCGAGGTTGAGTTTTGTTA	{9728} {9704} {9697}
5.717343925003942	11167	11333	166	11167	3	1.0	TGTCTAAGCATAGTGATTTTGGACTCGGTG TGTCTAAGCATAGTGATTTTGGTCTTGGCG TGTCTAAGCATAGTGATTTTGGTCTTGGTG	11303	3	1.0	TGAAAACGCAGTTGCAAATGGATCGTCACC TGAAAATGCTGTTGCAAATAGTTCCTCACC TGAAAATGCTGTTGCAAATGGTTCTTCACC	2	1.0	GCATCATCTTTTGTTGGTATGCCGTCTT TCGTCTTTTGTTGGTATGCCATCTTTTG	{11244} {11247}
5.7262905569654325	14313	14482	169	14313	3	1.0	CCAAATTCTATGGCGGTTGGGACAATATGC CCAAGTTTTATGGCGGTTGGGATAATATGT CCAAGTTTTATGGTGGCTGGGATAATATGT	14452	3	1.0	AGGTTCAAAGCACGTCACATGTTGTACGGC AGGTTCTAAACATGTTACATGTTGTACGGC AGGTTCTAAGCATGTCACATGTTGTACGGC	2	1.0	CCGATGTTGACGATCCTAAATTGATGGG TCAATGATTCGTATGCTGTCGGCCATGA	{14358} {14420}
5.728054842851936	26634	26849	215	26634	4	1.0	TATGGCCATAGCCACACTTGTTATGTGGGT TATGGCCGTATCAACACTCATTATGTGGGT TATGGCCGTATCAACACTCGTTATATGGGT TATGGCTATAGCCACATTTGTTATGTGGGT	26819	2	1.0	TGAGCGGCGTGCTTTACGTGGACGGACATA TGAGCGGTGTTCTTTACGTGGACGGCCATA	1	1.0	CCGACGTGCTCGAACTTTTTGGGCATGG	{26694}
5.7378437654486545	9776	9949	173	9776	2	1.0	TGGTGTTATGTATGGCGGTTTTGATGACCA TGGTGTTATGTATGGTGGTTTTGAAGACCA	9919	4	1.0	CTGTAGAACACTACAATGAATGGGCACAGA CTGTAGAACATTATAATGAGTGGGCACAGG CTGTGGAGCATTATAATGAGTGGGCACAGG CTGTTGAACACTATAATGAATGGGCACAGT	2	1.0	ACATGGTGGCTTAAAGGCGACAAATTGT ACCAGATGCTAACAGTTAATGTGGTCGC	{9891} {9832}
5.740229730317068	15171	15392	221	15171	5	1.0	GAAAGGTGTTTTATGCGCTTTTAGATTGGG GGAAAGTGTTTTATGCACTGTTAGACTGGG GGAAAGTGTTTTATGCACTTTTGGATTGGG GGAAGGTGTTCTATGCATTGTTAGACTGGG GGAAGGTGTTTTACGCATTGTTAGATTGGG	15362	1	1.0	TCTCAAACAGTTCTAAGATGCGGTGATTGT	1	1.0	CAAGAGTCCAAGTTTTGGGATGAAAGCT	{15269}
5.746148055426138	11795	11937	142	11795	4	1.0	GACATGTGAACGTGTTGTTAAACTGCAGAA GACCTGCGAACGTGTTGTCAAATTGCAGAA GACTTGTGAACGCGTCGTTAAATTGCAGAA GACTTGTGAACGTGTTGTCAAATTGCAGAA	11907	2	1.0	CTATACAACAATGAAGGTGGACGTGCATTT TTATACAATAATGAGGGTGGCCGTGCATTT	3	1.0	TAATGCCAGGTAAGATGAAAGTCAAAGC TGAAGGTCAAGGCCACCAAAGGTGAAGG TGAAGGTTAAAGCCACCAAAGCTGAAGG	{11833} {11848} {11848}
5.74809679600542	15740	15965	225	15740	4	1.0	GAAACGGTCAAGGCTAAAGAGGAAAGTGTT GAAACTGTCAAAGCTAAGGAGGAAAGTGTT GAAACTGTCAAGGCTAAAGAAGAAAGTGTG GAGACTGTGAAAGCTAAAGAGGAAAGCGTT	15935	2	1.0	GAGAAAGTAGATTATGGTTCTGATACGGTG GAGAAAGTGGATTATGGCTCTGACACGGTG	1	1.0	TGTAGGTCCTAAGGAACTTTTGCTCTCA	{15805}
5.754428507007025	8526	8705	179	8526	2	1.0	GTTTGCGGTACAGGTCTGTGGGATCTTGTG GTTTGTGGTACTGGTTTGTGGAACCTTGTA	8675	4	1.0	TAGACGCATGTTTGGCGATCTTTCTGTAGG TAGACGCATGTTTGGTGACCTTTCTGTAGG TAGACGCATGTTTGGTGATTTGTCTGTAGG TAGACGTATGTTTGGTGATCTTTCTGTGGG	2	1.0	ATACTATCCATGTTTTCATGTTCATTTT TTACTTAATTGTGCATTAGGTGCTTTCG	{8562} {8616}
5.761416028494806	3116	3262	146	3116	3	1.0	ACATGAAGGTGACTGGGATAGCTTTTGTAA ACATGAGGGTGACTGGGATAGTTTTTGTAA ACATGAGGGTGATTGGGACAGTTTTTGTGA	3232	3	1.0	TGACTTTGCCTGTCATGATTTCTGAGTGGC TGAGTTTGCCCGTTATGTTTTCTGAATGGC TGAGTTTGCCTGTTATGATTTCTGAATGGC	3	1.0	AACTATTCAATCAGCACTGTCTGTAGTT AACTATTCAATCAGCACTTTCTGTTGTT ACTGTAAATGCAGCTCTTGATGTAGTTT	{3146} {3146} {3147}
5.772751599001681	1157	1343	186	1157	3	1.0	AACGCAGAAAGCAGGCGTTGGTATTAAGTA AACTCAGCAAGCTGGTGCTGGTATTAAGTA TACTCAGCAAGCTGGTGTTGGTGTTAAGTA	1313	3	1.0	CAGAATGGATACATTCTGCTTCAATGTACG TAGAATGGACACATTCTGCTTCAATGTACG TAGAATGGATACACTCTGCTTCAATGTGCG	2	1.0	CTTAAGTTTGTTGCAAACATTGAAGGTG GTCTGGCGAGTAATCGCTGTTCAAAGTG	{1203} {1236}
5.788219948987033	14586	14833	247	14586	4	1.0	GTGACGCGACTACTGCTTATGCTAACTCTG GTGATGCAACTACAGCCTACGCCAATTCTG GTGATGCAACTACAGCTTATGCTAATTCTG GTGATGCAACTACTGCTTATGCCAACTCTG	14803	2	1.0	GATGATCCTTTCTGATGACGGTGTTGTGTG GATGATTCTTTCTGATGATGGTGTTGTGTG	1	1.0	AGAAATAGTAATGTCGATGAGTCTTTTG	{14735}
5.8019141342961085	15664	15862	198	15664	4	1.0	CACATCTGATTGGTCTGATATCCGTGACTA TACCTCTGATTGGTCTGACATTCGCGACTA TACTTCAGACTGGTCTGACATACGTGACTA TACTTCTGATTGGTCTGACATTCGTGACTA	15832	2	1.0	ATGGGAAAGTGGAAAAGCCAAACCACCGTT ATGGGAAAGTGGAAAAGCCAAACCGCCATT	2	1.0	ATTGTAGGTCCTAAGGAACTTTTGCTTT TTGTAGGTCCTAAGGAATTTTTGCTCTC	{15803} {15804}
5.806526686365171	16453	16653	200	16453	5	1.0	CGTAGATGAAGTGTCTATGTGCACCAATTA CGTAGATGAAGTGTCTATGTGCACTAACTA CGTGGATGAGGTGTCTATGTGCACTAACTA TGTAGATGAGGTGTCTATGTGCACCAACTA TGTGGATGAAGTGTCCATGTGCACTAACTA	16623	1	1.0	TGTGTGCTATAGGACCTGATGTCTTTTTAC	2	1.0	CCTAGGGTGCTTATATCCAAAGGAACTA GAGTTCTTATCTCTAAGGGTGTTATGGA	{16559} {16563}
5.824340537842752	12910	13118	208	12910	3	1.0	GGACTTGTGCTTTGCTCTGCGTAACTTTGA GGATTTGTGCTTCGCTCTGCGTAACTTTGA GGATTTGTGTTTTGCCCTGCGTAATTTTGA	13088	3	1.0	GCAATGATTAAATGTGTTGCGCTTTGTGAC GCAATGCTTAAGTGTGTTGCTCTTTGCGAC GCAATGCTTAAGTGTGTTGCTTTTTGCGAT	2	1.0	CTGATTACTTTGAAATGAAGAATTGGTT TTCTTACTGGTTGTTGTGGTACCGATTA	{12996} {12975}
5.828643513028184	1208	1343	135	1208	3	1.0	GTTCGTAGCTAGCATTGAGGGCGTTTCTGT GTTTGTTGCAAACATTGAAGGTGTCTCTGT GTTTGTTGCAAGCATTGAATGTGTCGCTGT	1313	3	1.0	CAGAATGGATACATTCTGCTTCAATGTACG TAGAATGGACACATTCTGCTTCAATGTACG TAGAATGGATACACTCTGCTTCAATGTGCG	4	1.0	GCTTTGTTGCTTCTTCCACTTTTGTAGA GGCGAGCAATTGCTGTTCAGAGTGTTGA TGGCGAGTAATCGCTGTTCAGAGTGTGG TGGCGAGTGATTGCTGTTCAAAGTGTAG	{1270} {1240} {1239} {1239}
5.828643513028184	25275	25485	210	25275	2	1.0	CAAGTGGCCGTGGTGGGTGTGGTTGTGCAT TAAGTGGCCATGGTGGGTGTGGTTGTGTAT	25455	4	1.0	ACAGTAATGGCTCTAGGTTTGTTCACATTG ACAGTAATGGCTCTAGGTTTGTTTACTCTG ACAGTAATGGCTTTAGGCTTGTTCACATTG TCAGTAATGGCTCTAGGCTTGTTCACACTT	2	1.0	AGGTTGTTGTGAGTCAACTAAACTTCCT GTCGCGCTCATCTTTGTGGTGAGTATGT	{25401} {25309}
5.8370799693424065	9800	10014	214	9800	3	1.0	AGACCAACCTAACCTTCAAGTTGAATCTGC GGACCAACCTAACCTTCAGGTTGAATCTGC TGACCAACCTAACCTTCAAGTTGAATCTGC	9984	3	1.0	TTCTCCATTCTTGCTGCTAAAACTGGCGTT TTTTCCATTCTTGCTGCTAAAACTGGTGTC TTTTCTATTCTTGCTGCAAAAACCGGTGTC	2	1.0	ACATGGTGGCTTAAAGGCGACAAATTGT ACCAGATGCTAACAGTTAATGTGGTCGC	{9891} {9832}
5.843219205502994	18603	18774	171	18603	3	1.0	CTGGCTTTAACATTTGGGTTCCTACCACGT CTGGTTTCAACATTTGGGTCCCTAACACAT CTGGTTTTAATATTTGGGTTCCTACCACGT	18744	3	1.0	TACCAGTAGCCATTAGTGGTGATAAAGTGT TACCAGTGGCTATTAGTGGTGATAAAGTGT TACCTGTGGCTATTAATGGCGACAAGGTGT	3	1.0	TACAGAGGTTAACCTGCAAGGTTTGGAA TGTGGCAAACATTTACAGAAGTAAATCT TGTTATAATTTGTGGCAGACATTCACAG	{18661} {18648} {18638}
5.848943765448655	5584	5757	173	5584	4	1.0	GTGACAAGGGTGATGCTGAAGACACTTTGA GTGCCAAAGGTGATGCTGAAGACACTTTGA GTGCTAAGGGTGATGCTGAAGATATTTTGA GTTCTAAGGGTGATGCTGAAGACACTTTGA	5727	2	1.0	ATAGTATGTGCTGGTGTTAAACGTGATGGT ATAGTTTGTGCTAGTGTCAAACGTGATGGT	3	1.0	AAGTTCAATTAGAACATTATAGTTCTTG AAGTTGTCTAAGTATCTTGCTAACGAAG AGTTGTCTAAGTATATCGCCAATGAGGC	{5647} {5616} {5617}
5.851329730317068	8484	8705	221	8484	2	1.0	GACAAGTGGTTTGTTAATGATGGAAGTGTG GACAAGTGGTTTGTTAATGATGGACGTGTT	8675	4	1.0	TAGACGCATGTTTGGCGATCTTTCTGTAGG TAGACGCATGTTTGGTGACCTTTCTGTAGG TAGACGCATGTTTGGTGATTTGTCTGTAGG TAGACGTATGTTTGGTGATCTTTCTGTGGG	2	1.0	TAATGGTTATGTTTGCGGTACAGGTCTG TGGTTATGTTTGTGGTACTGGTTTGTGG	{8516} {8519}
5.857343377117346	27096	27214	118	27096	4	1.0	TGGGCTGATGAGTCTGAGCAGCAGCGTGGT TGGGCTGATGCATCTGAACCACAACGTGGT TGGGCTGATGCTTCTGAACCACGGCGTGGT TGGGCTGATTCCTCTGAACCACAACGTGGT	27184	2	1.0	CTTGGAAAGTGATACCACGTGACTTGGTAC CTTGGAAGGTGATACCTCGTAATTTGGTAC	5	1.0	CGGGAAGAATTCCATATTCCTTGTACAG CGTCAGGCTAGAATCCCTTATTCTCTTT CGTCAGGGCAGAATACCTTATTCCCTTT CGTCAGGGTAGAATCCCTTATTCCGTTT GTTCAGGCAGAATCCCTTTTTCTCTTTA	{27130} {27126} {27126} {27126} {27127}
5.865528507007025	11423	11602	179	11423	1	1.0	GGCTGAACAAGCTGCTGCAGCTATGTATAA	11572	5	1.0	ATGGTGTTGTACCCCTCTCTGTTATTCCTG ATGGTGTTGTCCCTCTCTCTGTTATTCCTG ATGGTGTTGTCCCTCTTTCCGTTATCCCTG ATGGTGTTGTTCCTCTTTCTGTTATCCCTG ATGGTGTTGTTCCTCTTTCTGTTATTCCTG	3	1.0	ATCAAAAGTTGTAAGTGCAATGCATAGT GGTTGTTAGTGCAATGCATAGTTTACTC GTGTGGACACTATTCTTAACATGGCACG	{11477} {11483} {11542}
