cost	target-start	target-end	target-length	left-primer-start	left-primer-num-primers	left-primer-frac-bound	left-primer-target-sequences	right-primer-start	right-primer-num-primers	right-primer-frac-bound	right-primer-target-sequences	num-guides	total-frac-bound-by-guides	guide-target-sequences	guide-target-sequence-positions
2.9220738099539405	30624	30755	131	30624	1	0.9939759036144579	GCATGGAAGTCACACCTTCGGGAACATGGC	30725	1	0.9939759036144579	AAGCACATTGACGCATACAAAACATTCCCA	2	0.9939759036144579	AATTCAAAGACAGCGTCATACTGCTGAA TGACTTATCATGGAGCCATTAAATTGGA	{30696} {30654}
2.948079969342407	29817	29954	137	29817	1	0.9909638554216867	GGTTCACAGCTCTCACTCAGCATGGCAAGG	29924	1	0.9909638554216867	CGAAGAGCTACCCGACGAGTTCGTGGTGGT	2	0.9909638554216867	AGGAACTTAGATTCCCTCGAGGCCAGGG GGACTCAAATTCCCTCAAGGCCAGGGAG	{29847} {29849}
2.997385737400775	30154	30341	187	30154	1	0.9969879518072289	AACAACATTGCCAAAAGGCTTCTACGCAGA	30311	1	0.9909638554216867	ACTGCCCTCGCGCTATTGCTGCTAGACAGA	1	0.9819277108433735	TGCTCGAATGGCTAGCGGAGGTGGTGAA	{30283}
3.0121837571683643	30743	30936	193	30743	1	0.9939759036144579	AAAACATTCCCACCAACAGAGCCTAAAAAG	30906	1	0.9909638554216867	CTGCTGATTCAACTCAGGCATAAACACTCA	1	0.9819277108433735	CAACTTCAAGATTCCATGAGTGGAGCTT	{30878}
3.0851590937877345	30743	30970	227	30743	1	0.9939759036144579	AAAACATTCCCACCAACAGAGCCTAAAAAG	30940	1	0.9939759036144579	GACCACACAAGGCAGATGGGCTATGTAAAC	1	0.9909638554216867	TCCATGAGTGGAGCTTCTGCTGATTCAA	{30890}
3.1793942636811994	30253	30341	88	30253	2	0.9909638554216867	AACGCCTAGCAGTAGCAGAGGTTCATCACC AACTCCTGGCAGCAGTAGGGGAAATTCTCC	30311	1	0.9909638554216867	ACTGCCCTCGCGCTATTGCTGCTAGACAGA	1	0.9819277108433735	TGCTCGAATGGCTAGCGGAGGTGGTGAA	{30283}
3.2273354666358682	30665	30909	244	30665	1	0.9909638554216867	GGAGCCATTAAATTGGATGACAAAGATCCA	30879	1	0.9909638554216867	AACTTCAAAATTCCATGAGTGGAGCTTCTG	2	0.9939759036144579	AATTCAAAGACAGCGTCATACTGCTGAA GCGGCTGACATGGATGATTTCTCTAGAC	{30696} {30851}
3.4128433771173463	30852	30970	118	30852	2	0.9909638554216867	CGGCTGACATGGATGATTTCTCCAGACAAC CTGCAGATTTGGATGAATTCTCCAAACAGT	30940	1	0.9939759036144579	GACCACACAAGGCAGATGGGCTATGTAAAC	1	0.9909638554216867	TCCATGAGTGGAGCTTCTGCTGATTCAA	{30890}
3.469888527362399	1500	1609	109	1500	1	0.9909638554216867	CATTGAAACTCGACTCCGCAAGGGAGGTAG	1579	2	0.9909638554216867	AAGCGAGCCTACTGGGTCCCTCGTGCTAGT AAGCGTGCCTACTGGGTTCCTCGTGCTAGT	2	0.9819277108433735	CTAGATGTTTTGGAGGCTGTGTGTTTGC GACTAAGTGTTTTGGAGGCTGTGTATTT	{1532} {1530}
3.550107968360733	30787	30936	149	30787	2	0.9939759036144579	GACTGATGAAGCTCAGCCTTTGCCGCAGAG GGCTGATGAACTTCAGGCTTTACCGCAGAG	30906	1	0.9909638554216867	CTGCTGATTCAACTCAGGCATAAACACTCA	1	0.9819277108433735	CAACTTCAAGATTCCATGAGTGGAGCTT	{30878}
3.584243040981689	30852	31011	159	30852	2	0.9909638554216867	CGGCTGACATGGATGATTTCTCCAGACAAC CTGCAGATTTGGATGAATTCTCCAAACAGT	30981	1	0.9939759036144579	TCCGTTTACGATACATAGTCTACTCTTGTG	1	0.9909638554216867	TCCATGAGTGGAGCTTCTGCTGATTCAA	{30890}
3.653826723086379	30787	30970	183	30787	2	0.9939759036144579	GACTGATGAAGCTCAGCCTTTGCCGCAGAG GGCTGATGAACTTCAGGCTTTACCGCAGAG	30940	1	0.9939759036144579	GACCACACAAGGCAGATGGGCTATGTAAAC	1	0.9909638554216867	TCCATGAGTGGAGCTTCTGCTGATTCAA	{30890}
3.6640857374007747	30623	30810	187	30623	1	0.9939759036144579	GGCATGGAAGTCACACCTTCGGGAACATGG	30780	2	0.9909638554216867	AGAAAAAGACTGATGAAGCTCAGCCTTTGC AGAAGAAGGCTGATGAAGTACAGCCTCTGC	1	0.9909638554216867	CTGACTTATCATGGAGCCATTAAATTGG	{30653}
3.7111377053709504	27203	27367	164	27203	1	0.9909638554216867	CTTGATGTGGCTTAGCTACTTCGTTGCTTC	27337	2	0.9909638554216867	TAGAGAGTGAACTCGTAATTGGAGCTGTGA TGGAAAGTGAACTTGTCATTGGTGCTGTGA	2	0.9819277108433735	CATTCTTCTCAATGTGCCTCTCCGGGGG CCGAGGGACAATTTTGACCAGACCGCTC	{27287} {27308}
3.746048055426138	30787	31011	224	30787	2	0.9939759036144579	GACTGATGAAGCTCAGCCTTTGCCGCAGAG GGCTGATGAACTTCAGGCTTTACCGCAGAG	30981	1	0.9939759036144579	TCCGTTTACGATACATAGTCTACTCTTGTG	1	0.9909638554216867	TCCATGAGTGGAGCTTCTGCTGATTCAA	{30890}
3.7649267230863788	29817	30000	183	29817	1	0.9909638554216867	GGTTCACAGCTCTCACTCAGCATGGCAAGG	29970	2	0.9909638554216867	AGCTCAGCCCCAGATGGTACTTCTATTACC AGCTCAGCCCCAGATGGTACTTTTACTACC	2	0.9909638554216867	AGGAACTTAGATTCCCTCGAGGCCAGGG GGACTCAAATTCCCTCAAGGCCAGGGAG	{29847} {29849}
3.7668591090491432	30577	30812	235	30577	1	0.9939759036144579	ACAATTTGCTCCAAGTGCCTCTGCATTCTT	30782	2	0.9909638554216867	AAAAAGACTGATGAAGCTCAGCCTTTGCCG AAGAAGGCTGATGAAGTACAGCCTCTGCCG	1	0.9939759036144579	CTTCGGGAACATGGCTGACTTATCATGG	{30639}
3.7700972680519156	27351	27536	185	27351	2	0.9939759036144579	GTAATTGGAGCTGTGATCCTTCGTGGACAT GTCATTGGTGCTGTGATCATTCGTGGTCAC	27506	1	0.9909638554216867	TTCAGGTTTTGCTGCATACAACCGCTACCG	2	0.9819277108433735	GCGAATGGCAGGACACTCCCTAGGGCGC TAGGAGCGTCGCAGCGTGTAGGCACTGG	{27383} {27478}
3.7723079683607335	30157	30395	238	30157	2	0.9939759036144579	AACATTGCCAAAAGGCTTCTACGCAGAGGG AACATTGCCCAAAGGCTTCTACGCAGAAGG	30365	1	0.9909638554216867	TCTGGTAAAGGCCAACAACAACAAGGCCAA	1	0.9819277108433735	TGCTCGAATGGCTAGCGGAGGTGGTGAA	{30283}
3.7758897580044537	305	545	240	305	1	0.9909638554216867	GACCGAAAGGTAAGATGGAGAGCCTTGTTC	515	2	0.9909638554216867	AGCCCTATGTGTTCATTAAACGATCTGAAG AGCCCTATGTGTTCATTAAACGTTCTGATG	1	0.9789156626506024	TTCAGGTTAGAGACGTGCTAGTGCGTGG	{380}
3.7826701280549226	348	538	190	348	1	0.9939759036144579	GAAAACACACGTCCAACTCAGTTTGCCTGT	508	2	0.9909638554216867	CTTGAACAGCCCTATGTGTTCATTAAACGT CTTGAAGAGCCCTATGTGTTCATTAAACGA	2	0.9879518072289156	TCCAGGTTAGAGACGTGTTAGTACGTGG TTCAGGTTAGAGACGTGCTAGTGCGTGG	{380} {380}
3.7994827288338286	29703	29900	197	29703	1	0.9939759036144579	GCATTACATTTGGTGGACCCACAGATTCAA	29870	2	0.9909638554216867	CAGGGAGTTCCTATCAACACCAATAGTGGC CAGGGCGTTCCAATCAACACCAATAGTGGT	2	0.9849397590361446	ACTCAGCATGGTAAGGAGGAACTTAGAT CCAGGATGGAGGACGCAGTGGTGTACGG	{29831} {29743}
3.808708310503012	1162	1363	201	1162	1	0.9909638554216867	GTCAAAGTCATTCAACCACGTGTTGAAAAG	1333	2	0.9909638554216867	AAAGCCACTTGTGAACATTGTGGCACTGAA AGAGCCACTTGCGAATTCTGTGGTACTGAA	2	0.9849397590361446	AAAAATACTGAAGGTTTCATGGGGCGTA CACTTGTCTACCTTGATGAAATGTAATC	{1192} {1267}
3.834891578646307	29817	30030	213	29817	1	0.9909638554216867	GGTTCACAGCTCTCACTCAGCATGGCAAGG	30000	2	0.9909638554216867	TAGGAACAGGACCAGAGGCTGCATTACCTT TAGGAACTGGCCCAGAAGCTTCACTTCCCT	2	0.9909638554216867	AGGAACTTAGATTCCCTCGAGGCCAGGG GGACTCAAATTCCCTCAAGGCCAGGGAG	{29847} {29849}
3.877959109049143	26776	27011	235	26776	1	1.0	CGTACTGCTGCAATATTGTTAACGTGAGTT	26981	2	0.9909638554216867	ACTCCTGGAACAATGGAACCTAGTAATAGG GCTCTTAGAACAATGGAACCTAGTAATAGG	2	0.9879518072289156	CAACAGTTTATGTCTACTCGCGTGTTAA TTAAAAATCTGAACTCTTCTGAAGGAGT	{26815} {26839}
3.8869897580044537	516	756	240	516	2	0.9909638554216867	GCCCTATGTGTTCATTAAACGATCTGAAGC GCCCTATGTGTTCATTAAACGTTCTGATGC	726	1	0.9909638554216867	TGGCATCGATCTAAAGTCTTATGACTTAGG	2	0.9879518072289156	CACAAGGTTGTGGAATTGGTTGCAGAAT CACTGGGAGTACTCGTGCCACATGTGGG	{565} {626}
3.8992199489870325	26981	27228	247	26981	2	0.9909638554216867	ACTCCTGGAACAATGGAACCTAGTAATAGG GCTCTTAGAACAATGGAACCTAGTAATAGG	27198	1	0.9909638554216867	GTAGGCTTGATGTGGCTTAGCTACTTCGTT	2	0.9849397590361446	CTTGTTTTCCTCTGGCTCTTGTGGCCGG GTGACTGGCGGGATTGCGATTGCAATGG	{27087} {27162}
3.8992199489870325	27351	27598	247	27351	2	0.9939759036144579	GTAATTGGAGCTGTGATCCTTCGTGGACAT GTCATTGGTGCTGTGATCATTCGTGGTCAC	27568	1	0.9909638554216867	CCGGTAGCAACGACAATATTGCTTTGCTAG	2	0.9819277108433735	GCGAATGGCAGGACACTCCCTAGGGCGC TAGGAGCGTCGCAGCGTGTAGGCACTGG	{27383} {27478}
4.442589758004454	30260	30500	240	30260	2	0.9909638554216867	AGCAGTAGCAGAGGTTCATCACCAGCACGA GGCAGCAGTAGGGGAAATTCTCCTGCTCGA	30470	2	0.9909638554216867	GTCACCCAAGCTTTTGGGCGACGTGGTCCA GTCACTCAAGCATTTGGGAGACGTGGTCCA	1	0.9909638554216867	GCTAGCGGAGGTGGTGAAACTGCCCTCG	{30293}
4.446131969052151	30623	30865	242	30623	1	0.9939759036144579	GGCATGGAAGTCACACCTTCGGGAACATGG	30835	3	0.9909638554216867	TGTGACTCTTCTTCCTGCGGCTGACATGGA TGTGACTCTTCTTCCTGCGGCTGATATGGA TGTGACTCTTCTTCCTGCTGCAGATTTGGA	1	0.9909638554216867	CTGACTTATCATGGAGCCATTAAATTGG	{30653}
4.449635466635868	30487	30731	244	30487	2	0.9909638554216867	GAGACGTGGTCCAGAACAAACCCAAGGAAA GCGACGTGGTCCAGATCAAACTCAAGGAAA	30701	2	0.9909638554216867	AAAGACAACGTCATACTGCTGAACAAGCAC AAAGACAACGTCATACTGCTGAATAAGCAC	1	0.9939759036144579	CTTCGGGAACATGGCTGACTTATCATGG	{30639}
4.48876719502264	13784	13991	207	13784	3	0.9909638554216867	TCCTAAAAACTAATTGCTGCCGATTCCAGG TCCTAAAAACTAATTGCTGTCGCTTCCAGG TCCTAAAGACTAATTGCTGCCGCTTCCAAG	13961	1	0.9969879518072289	ATGGTGACATGGTACCACATATATCACGTC	2	0.9909638554216867	AGAAGGATGAAGAAGGCAATTTAATAGA AGAAGGATGAGGAAGGCAATTTATTAGA	{13814} {13814}
4.501591578646307	27277	27490	213	27277	3	0.9909638554216867	CAGAAACAAACATTCTTCTCAATGTGCCTC CAGAAACTAACATTCTTTTGAACGTGCCTC CGGAAACAAACATTCTTCCCAATGTGCCTC	27460	1	0.9909638554216867	CGCTTTCTTATTACAAATTAGGAGCGTCGC	2	0.9849397590361446	GGGACAATTGTGACCAGACCGCTCATGG TCCGAGGGACAATTTTGACCAGACCGCT	{27312} {27307}
4.521887395870145	1386	1609	223	1386	2	0.9909638554216867	TACATGTGGGTACCTACCTACTAATGCTGT TACGTGTGGATACCTACCTGCTAATGCTGT	1579	2	0.9909638554216867	AAGCGAGCCTACTGGGTCCCTCGTGCTAGT AAGCGTGCCTACTGGGTTCCTCGTGCTAGT	2	0.9819277108433735	CTAGATGTTTTGGAGGCTGTGTGTTTGC GACTAAGTGTTTTGGAGGCTGTGTATTT	{1532} {1530}
4.542726723086379	18373	18556	183	18373	1	0.9909638554216867	CATACCAGGCATACCAAAGGACATGACCTA	18526	3	0.9909638554216867	GGGCTGTCATGCAACTAGAGATGCTGTGGG GGGTTGTCATGCAACAAGGGATGCTGTGGG GGGTTGTCATGCTACTAGAGATGCTGTAGG	3	0.9879518072289156	CGAAGAAGCTATTCGTCACGTTCGTGCG CGCGAAGAGGCCATTCGTCACGTTCGTG CGTGAAGAAGCCATTCGTCACGTTCGTG	{18478} {18476} {18476}
4.55723196905215	1162	1404	242	1162	1	0.9909638554216867	GTCAAAGTCATTCAACCACGTGTTGAAAAG	1374	3	0.9939759036144579	AGAAGGTGCCACAACTTGTGGTTACTTACC TGAAGGACCCACTACATGTGGATACCTACC TGAAGGACCTACTACATGTGGGTACCTACC	2	0.9789156626506024	AAAAATACTGAAGGTTTCATGGGGCGTA GTTTCATGGCAGACGTGCGACTTTCTGA	{1192} {1306}
4.659401953228442	1293	1530	237	1293	3	0.9909638554216867	CCATTGTGGTGAAACTTCATGGCAGACGGG TCATTGCGATGAAGTTTCATGGCAGACGTG TCATTGTGATGAAGCTTCTTGGCAGACGTG	1500	1	0.9909638554216867	CATTGAAACTCGACTCCGCAAGGGAGGTAG	3	0.9849397590361446	CGACTTTCTGAGAGCCACTTGTGAACAT TGAATATTGTGGCACTGAAAATCCAGTG TGTGAAGGACCCACTACATGTGGATACC	{1323} {1344} {1372}
4.676564373321448	27277	27370	93	27277	3	0.9909638554216867	CAGAAACAAACATTCTTCTCAATGTGCCTC CAGAAACTAACATTCTTTTGAACGTGCCTC CGGAAACAAACATTCTTCCCAATGTGCCTC	27340	2	0.9909638554216867	AAAGTGAACTTGTCATTGGTGCTGTGATCA AGAGTGAACTCGTAATTGGAGCTGTGATCC	2	0.9849397590361446	GGGACAATTGTGACCAGACCGCTCATGG TCCGAGGGACAATTTTGACCAGACCGCT	{27312} {27307}
4.7291181283451795	26981	27151	170	26981	2	0.9909638554216867	ACTCCTGGAACAATGGAACCTAGTAATAGG GCTCTTAGAACAATGGAACCTAGTAATAGG	27121	2	0.9939759036144579	TTGCTTGCTTTGTGCTTGCTGCTGTTTACA TTGCTTGTTTTGTGCTTGCTGCTGTCTACA	5	0.9909638554216867	ATTCTTGTTTCTTACATGGATTTGTTTG TTATGTTATTACAATTTGCCTATTCTAA TTGTTTTCCTGTGGCTCTTGTGGCCAGT TTTCATTTTCCTTGCCTGGATTATGCTG TTTCATTTTCCTTGCTTGGATTATGTTA	{27011} {27031} {27088} {27011} {27011}
4.846094263681199	422	538	116	422	3	0.9909638554216867	TGGAAGAAGCCCTAGCGGAAGCACGTGAAC TGGAAGAGGCCCTATCGGAGGCACGTGAAC TTGAAGAAGCTATCACTGAAGCACGTCAAC	508	2	0.9909638554216867	CTTGAACAGCCCTATGTGTTCATTAAACGT CTTGAAGAGCCCTATGTGTTCATTAAACGA	2	0.9819277108433735	AGAGCTGGAAAAAGGCGTACTGCCCCAG TAGTAGAGCTGGAAAAAGGTGTTTTACG	{480} {476}
4.913014134296109	27127	27256	129	27127	2	0.9909638554216867	GCTTTGTGCTTGCTGCTGTTTACAGAATTA GTTTTGTGCTTGCTGCTGTCTACAGAATTA	27226	3	0.9909638554216867	TTGCATCATTCAGGCTTTTTGCACGCACTA TTGCTTCCTTCAGGCTGTTTGCTCGTACCC TTGCTTCTTTCAGGCTGTTTGCTCGCACCC	2	0.9759036144578314	GTGACTGGCGGGATTGCGATTGCAATGG TTGGGTGACTGGCGGGATTGCGACTGCA	{27162} {27158}
4.917643040981689	735	894	159	735	1	0.9909638554216867	TCTAAAGTCTTATGACTTAGGTGACGAGCT	864	4	0.9909638554216867	CACTCGCTATGTCGACAACAACTTCTGTGG CACTCGCTATGTCGACAACAATTTCTGTGG CACTCGCTATGTTGATAACAACTTTTGTGG TACTCGCTATGTCGACAACAACTTTTGTGG	1	0.9849397590361446	TCCCATTGAAGATTATGAACAAAACTGG	{774}
4.984609836406474	1293	1414	121	1293	3	0.9909638554216867	CCATTGTGGTGAAACTTCATGGCAGACGGG TCATTGCGATGAAGTTTCATGGCAGACGTG TCATTGTGATGAAGCTTCTTGGCAGACGTG	1384	2	0.9909638554216867	ACTACATGTGGGTACCTACCTACTAATGCT ACTACGTGTGGATACCTACCTGCTAATGCT	3	0.9849397590361446	CGACTTTCTGAGAGCCACTTGTGAACAT TGAACAATGTGGCACTGAAAACCCAGTC TGAACAATGTGGCACTGAAAATTTAGTT	{1323} {1344} {1344}
5.071143765448655	26776	26949	173	26776	1	1.0	CGTACTGCTGCAATATTGTTAACGTGAGTT	26919	4	0.9909638554216867	GGAACTTTAACATTGCTTATCATGGCAGAC GGAACTTTAACATTGCTTATCATGGCTGAG GGAACTTTAACATTGCTTGTCATGGCAGAG GGAACTTTAATTTTAGCCATGTCAGGTGAC	2	0.9879518072289156	CAACAGTTTATGTCTACTCGCGTGTTAA TTAAAAATCTGAACTCTTCTGAAGGAGT	{26815} {26839}
5.0947160284948065	18652	18884	232	18652	3	0.9909638554216867	CAGAGTTAATGCAAAACCTCCACCAGGTGA CAGAGTTAATGCAAAACCTCCTCCAGGTGA TAGAGTCAATGCAAAACCTCCTCCAGGTGA	18854	2	0.9909638554216867	GGACCTGAAAGAACGTGTTGTCTGTGCGAC GGACCTGAAAGAACGTGTTGTCTGTGTGAC	1	0.9879518072289156	CTGAAAGGATTGTCAGACAGAGTCGTGT	{18770}
5.1020857056612074	6468	6616	148	6468	4	0.9909638554216867	GTGCATACGTTGTCTTTGGAGTACAAAACC GTGTTTACGTTGTCTGTGGAGTACAAAACC GTGTTTACGTTGTCTTTGGAGTACAAAGCC GTGTTTGCGTTGTCTTTATAGCACTAAACC	6586	1	0.9939759036144579	CTCTGAAGAAGTAGTGGAAAATCCTACCAT	3	0.9819277108433735	AGTAGATACTTCAAATTCATTTGAAGTT GTTCTGGCAGTAGAAGACACACAAGGAA TTTGAAGTTCTGGCAGTAGAAGACACAC	{6498} {6523} {6517}
5.159799245246692	13680	13889	209	13680	1	0.9969879518072289	TAAGTGCAGCCCGTCTTACACCGTGCGGCA	13859	4	0.9939759036144579	AGAGACACACGATGTCCAACTACCAACATG AGAGACATACTATGTCCAACTACCAGCATG AGAGGCACACAATGTCCAACTACCAACATG AGAGGCATACTATGTCTAACTACCAACATG	2	0.9879518072289156	ATTCCAGGAGAAGGATGAAGAAGGCAAT GAGAAGGATGAGGAAGGCAATTTATTAG	{13806} {13813}
5.2186038657081175	12621	12860	239	12621	1	0.9939759036144579	GATGGTTGTGTTCCACTCAACATCATACCA	12830	4	0.9909638554216867	TTGGCCTCTTATTGTTACAGCGCTAAGAGC TTGGCCTCTTATTGTTACAGCTCTAAGAGC TTGGCCTCTTATTGTTACTGCACTAAGAGC TTGGCCTCTTATTGTTACTGCTTTAAGAGC	2	0.9819277108433735	ACTTATGGTTGTTGTCCCTGATTATGGT CATGGTTGTTGTGCCTGACTATGGAACC	{12668} {12671}
5.2256885040667145	27277	27520	243	27277	3	0.9909638554216867	CAGAAACAAACATTCTTCTCAATGTGCCTC CAGAAACTAACATTCTTTTGAACGTGCCTC CGGAAACAAACATTCTTCCCAATGTGCCTC	27490	2	0.9939759036144579	AGCGTGTAGGCAACGATTCAGGTTTTGCTG AGCGTGTAGGCACTGATTCAGGTTTTGCTG	2	0.9849397590361446	GGGACAATTGTGACCAGACCGCTCATGG TCCGAGGGACAATTTTGACCAGACCGCT	{27312} {27307}
5.2256885040667145	29817	30060	243	29817	1	0.9909638554216867	GGTTCACAGCTCTCACTCAGCATGGCAAGG	30030	4	0.9939759036144579	ACGGCGCTAACAAAGAAGGCATCGTATGGG ATGGCGCTAATAAAGAAGGCATCGTATGGG ATGGTGCCAATAAAGAAGGCATCGTATGGG ATGGTGCTAACAAAGAAGGCATCATATGGG	2	0.9909638554216867	AGGAACTTAGATTCCCTCGAGGCCAGGG GGACTCAAATTCCCTCAAGGCCAGGGAG	{29847} {29849}
5.232064373321449	516	642	126	516	2	0.9909638554216867	GCCCTATGTGTTCATTAAACGATCTGAAGC GCCCTATGTGTTCATTAAACGTTCTGATGC	612	3	0.9909638554216867	TCGTAGCGGTACAACACTGGGAGTTCTCGT TCGTAGCGGTATAACACTGGGAGTACTCGT TCGTAGCGGTATAACTCTGGGAGTGCTCGT	5	0.9819277108433735	ATCACGGCCACAAGGTCGTTGAGCTGGT TCGTTGAGCTGGTTGCAGAAATGGACGG TCGTTGAGCTGGTTGCAGAATTGGACGG TGGTGGCTGAAATGAATGGCATTCAGTT TTGCAGAATTAGATGGCATTCAGTTCGG	{557} {572} {572} {581} {584}
5.2621757998013186	612	817	205	612	3	0.9909638554216867	TCGTAGCGGTACAACACTGGGAGTTCTCGT TCGTAGCGGTATAACACTGGGAGTACTCGT TCGTAGCGGTATAACTCTGGGAGTGCTCGT	787	2	0.9909638554216867	TATGAACAAAACTGGAACACTAAGCATGGC TATGAACAACAATGGAACACTAAGCATGGC	3	0.9819277108433735	CATAGCTTTGGCATCGATCTAAGGTCTT GCCACATGTGGGCGAAACCCCAGTTGCG GCTTTGGCATCGATCTAAAGTCTTATGA	{718} {642} {722}
5.285616373031192	18397	18613	216	18397	2	0.9909638554216867	GACCTACCGTAGACTCATCTCTATGATGGG GACCTATCGCAGACTCATCTCTATGATGGG	18583	3	0.9939759036144579	TTCAACAGGTGTTAACCTAGTAGCTGTACC TTCAACAGGTGTTAACCTAGTGGCCGTACC TTCTACAGGTGTTAACTTAGTAGCTGTACC	3	0.9879518072289156	CGAAGAAGCTATTCGTCACGTTCGTGCG CGCGAAGAGGCCATTCGTCACGTTCGTG CGTGAAGAAGCCATTCGTCACGTTCGTG	{18478} {18476} {18476}
5.297714670640964	7581	7803	222	7581	3	0.9909638554216867	GCAATGGTTAGGATGTACATCTTCTTTGCT GCAATGGTTAGGATGTACATTTTCTTCGCT GCTATGGTCAGGATGTACATTTTCTTTGCT	7773	2	0.9909638554216867	GGCTTCTGCAAGACTCACAATTGGAATTGT GGCTTCTGTAAGGCTCACAATTGGAATTGT	3	0.9879518072289156	CATGGATGGTTGCACCTCTTCGACTTGC CGACACGTGTTGAGTGTACAACTATTGT GTTCATATTATGGATGGTTGCACTTCTT	{7646} {7699} {7638}
5.384143513028184	21446	21581	135	21446	1	0.9909638554216867	CTCATGGTGGACAGCTTTTGTTACAAATGT	21551	4	0.9909638554216867	CACCATGCACGCTAACTACATTTTTTGGAG TACCATGCATGCTAACTACATCTTTTGGAG TACCATGCATGCTAACTACATTTTCTGGAG TACCATGCATGCTAACTACGTCTTCTGGAG	6	0.9819277108433735	ATCTTGGCAAGCCGAAGGAACAAATTGA ATCTTGGTAAACCAAAAGAGCAAATTGA GGAGTTAATTATCTTGGCAAGCTAAAGG GGTTAACTATCTAGGCAAGCCAAAGGAA TAATTACCTTGGTAAGCCGAAAGAGCAA TATCTTGGAAAGCCAAAAGAACAAATTG	{21517} {21517} {21507} {21509} {21512} {21516}
5.429109836406473	735	856	121	735	1	0.9909638554216867	TCTAAAGTCTTATGACTTAGGTGACGAGCT	826	5	0.9909638554216867	ACCCGTGAACTCAAGCGTGAGCTTAACGGA CTCCGCGAACTCATTCGTGAGCTCAACGGA CTCCGTGAACTCACTCGTGAGCTCAATGGA CTCCGTGAACTCATCCGTGAGCTCAATGGA CTCCGTGAACTCATTCGTGAGCTTAATGGA	1	0.9849397590361446	TCCCATTGAAGATTATGAACAAAACTGG	{774}
5.459921916171137	11408	11658	250	11408	2	0.9909638554216867	ATGATTTACATGCCTGCTAGTTGGGTTATG ATGGTCTACATGCCTGCTAGCTGGGTGATG	11628	3	0.9909638554216867	ATGCTTTAGATCAAGCTATTTCCATGTGGG ATTCCTTAGATCAAGCTATTTCCATGTGGG ATTCTTTAGACCAAGCTATTTCCATGTGGG	4	0.9789156626506024	CTTAGTTTTGCTTATCCTCATGACTGCC CTTGATGAATGTCATCACACTTGTTTAT TAGTTTTGCTTGTCCTCATGACAGCTCG TTTAGTTTTGCTTTTTCTCATGACAGCT	{11518} {11584} {11520} {11518}
5.469988527362399	351	460	109	351	2	0.9909638554216867	AACACACGTCCAACTCAGTTTACCTGTTCT AACACACGTCCAACTCAGTTTGCCTGTCCT	430	4	0.9909638554216867	GCCCTAGCGGAAGCACGTGAACATCTTAAA GCCCTATCGGAGGCACGTGAACACCTCAAA GCCCTATCGGAGGCACGTGAACATCTTAAA GCTTTATCAGAGGCACGTCAACATCTTAAA	2	0.9879518072289156	CCAGGTTAGAGACGTGTTAGTACGTGGC TCAGGTTAGAGACGTGCTAGTGCGTGGC	{381} {381}
5.567729642842771	30269	30423	154	30269	4	0.9909638554216867	AGAGGTTCATCACCAGCACGAAACCTGCAA AGGGGAAATTCTCCTGCTCGAATGGCTAGC AGGGGAACTTCTCCTGCTCGAATTGCTAGT AGGGGAAGTTCTCCTGCTCGATTGGCTAGC	30393	2	0.9939759036144579	AAACTGTCACTAAGAAATCTGCTGCTGAGG AAACTGTCACTAAGAAATCTGCTTCAGAGG	1	0.9909638554216867	GGAGGTGGTGAAACTGCCCTCGCGCTAT	{30299}
5.581088527362399	787	896	109	787	2	0.9909638554216867	TATGAACAAAACTGGAACACTAAGCATGGC TATGAACAACAATGGAACACTAAGCATGGC	866	4	0.9939759036144579	CTCGCTATGTCGACAACAACTTTTGTGGCC CTCGCTATGTCGACAACAATTTCTGTGGCC CTCGCTATGTTGATAACAACTTTTGTGGCC CTCGTTATGTCGACAACAACTTCTGTGGCC	3	0.9819277108433735	CACTCGTGAGCTCAACGGAGGCGCAGTT GGTGGTGTACTCCGTGAACTCATCCGTG TCACTCGTGAGCTCAATGGAGGTGCAGT	{837} {817} {836}
5.597040417140111	18721	18884	163	18721	4	0.9909638554216867	ACCCTGGAACATAGTGCGTATCAAGATAGT GCCCTGGAACGTGGTGCGTATTAAGATTGT GCCCTGGAATGTAGTGCGTATTAAGATAGT GCCCTGGAATGTTGTGCGTATTAAGATCGT	18854	2	0.9909638554216867	GGACCTGAAAGAACGTGTTGTCTGTGCGAC GGACCTGAAAGAACGTGTTGTCTGTGTGAC	1	0.9879518072289156	CTGAAAGGATTGTCAGACAGAGTCGTGT	{18770}
5.6238942636811995	27657	27829	172	27657	2	0.9909638554216867	GACTTCCAGGTTACAATAGCAGAGATATTG GACTTTCAGGTTACAATAGCAGAGATGTTG	27799	4	0.9909638554216867	CCTCAGTTAGATGATGAAGAACCTATGGAG TCAGAGTTAGATGATGAAGTACCTATGGAG TCGGAGTTAGATGATGAAGAACCTATGGAG TCTTAGTTAGATGATGACGAACCTATGGAG	1	0.9909638554216867	GAGACAATTATTTAAGCCTCTAACTAAG	{27762}
5.698664845367944	27277	27437	160	27277	3	0.9909638554216867	CAGAAACAAACATTCTTCTCAATGTGCCTC CAGAAACTAACATTCTTTTGAACGTGCCTC CGGAAACAAACATTCTTCCCAATGTGCCTC	27407	3	0.9939759036144579	ACGCTGTGACATCAAGGACCTGCCAAAAGA GCGCTGTGACATTAAGGACCTGCCAAAAGA GCGCTGTGACATTAAGGACCTGCCAAAGGA	2	0.9849397590361446	GGGACAATTGTGACCAGACCGCTCATGG TCCGAGGGACAATTTTGACCAGACCGCT	{27312} {27307}
5.723891578646308	681	894	213	681	2	0.9969879518072289	TCTTCTCCGTAAGAATGGTAATAAGGGAGC TCTTCTTCGTAAGAACGGTAATAAGGGAGC	864	4	0.9909638554216867	CACTCGCTATGTCGACAACAACTTCTGTGG CACTCGCTATGTCGACAACAATTTCTGTGG CACTCGCTATGTTGATAACAACTTTTGTGG TACTCGCTATGTCGACAACAACTTTTGTGG	1	0.9849397590361446	TCCCATTGAAGATTATGAACAAAACTGG	{774}
5.7301163730311915	7775	7991	216	7775	2	0.9909638554216867	CTTCTGCAAGACTCACAATTGGAATTGTCT CTTCTGTAAGGCTCACAATTGGAATTGTCT	7961	4	0.9909638554216867	TGACAAGGCTGGTCAAAAGACCTATGAGAG TGACAAGGCTGGTCAAAAGACTTACGAGAG TGATAAGGCTGGTCAAAAGACTTATGAGAG TGATAAGGCTGGTCAGAAGACTTACGAGAG	1	0.9909638554216867	CTCGTGATTTGTCACTCCAGTTTAAAAG	{7855}
5.748995040691432	18642	18819	177	18642	3	0.9909638554216867	CAGAATTCACCAGAGTTAATGCAAAACCTC CAGAGTTCACTAGAGTCAATGCAAAACCTC CGGAGTTCACTAGAGTTAATGCAAAACCTC	18789	3	0.9909638554216867	GAGTCGTGTTCGTCCTTTGGGCGCATGGCT GAGTCGTGTTTGTCCTTTGGGCGCATGGCT GAGTTGTGTTTGTCCTCTGGGCACATGGCT	2	0.9969879518072289	CAAATGCTCAGTGACACGCTGAAAGGAT TCAGTGATACACTGAAAGGATTGTCAGA	{18752} {18759}
5.753872931341441	787	1015	228	787	2	0.9909638554216867	TATGAACAAAACTGGAACACTAAGCATGGC TATGAACAACAATGGAACACTAAGCATGGC	985	4	0.9909638554216867	CAGTCTAAGAGAGGTGTGTACTGTTGCCGT GAATCGAAGAGAGGCGTCTACTGCTGCCGT GAATCGAAGCGTGGTGTCTATTGCTGCCGT GAGTCGAAGAGAGGTGTCTACTGCTGCCGT	1	0.9879518072289156	GCGGGCAAGTCAATGTGCACTCTTTCCG	{940}
5.766959109049143	735	970	235	735	1	0.9909638554216867	TCTAAAGTCTTATGACTTAGGTGACGAGCT	940	5	0.9909638554216867	GCCGGCAAATCTTGTGCTCCACTCTCTGAC GCGGGCAAATCGATGTGCACTCTTTCTGAA GCGGGCAAGTCAATGTGCACTCTTTCCGAA GCGGGTAAGTCGATGTGCACTCTTTCCGAA GCGGGTAAGTCTATGTGCACTCTTTCTGAA	1	0.9849397590361446	TCCCATTGAAGATTATGAACAAAACTGG	{774}
5.793321916171137	18569	18819	250	18569	3	0.9969879518072289	CTCCAATTAGGATTTTCGACAGGTGTTAAC CTCCAGCTAGGATTTTCTACAGGTGTTAAC CTCCAGTTAGGGTTTTCAACAGGTGTTAAC	18789	3	0.9909638554216867	GAGTCGTGTTCGTCCTTTGGGCGCATGGCT GAGTCGTGTTTGTCCTTTGGGCGCATGGCT GAGTTGTGTTTGTCCTCTGGGCACATGGCT	1	0.9909638554216867	AGAGTTAATGCAAAACCTCCTCCAGGTG	{18653}
5.794868425664694	26287	26482	195	26287	5	0.9909638554216867	GTTATTCCGAGGATTGGCATTCAGGTGTAA GTTATTCTGAGAATTGGCACTCAGGTGTTA GTTATTCTGAGGATAGGCACTCAGGTGTTA GTTATTCTGAGGATTGGCATTCAGGTGTTA GTTTTGTAGAAAAATGGGAGTCTGGTGTCA	26452	1	0.9909638554216867	ATGTGCAAATACACACAATCGACGGCTCTT	2	0.9849397590361446	AAGACTATGTAGTAATACATGGCTATTT CATGGCTATTTCGCCGAAGTTCACTACC	{26317} {26334}
5.797234243325825	6468	6664	196	6468	4	0.9909638554216867	GTGCATACGTTGTCTTTGGAGTACAAAACC GTGTTTACGTTGTCTGTGGAGTACAAAACC GTGTTTACGTTGTCTTTGGAGTACAAAGCC GTGTTTGCGTTGTCTTTATAGCACTAAACC	6634	2	0.9909638554216867	GTGTAATGTGAAAACTACCGAAGTTGTAGG GTGTGACGTGAAAACTACCGAAGTTGTAGG	2	0.9819277108433735	GTTCTGGCAGTAGAAGACACACAAGGAA TTTGAAGTTCTGGCAGTAGAAGACACAC	{6523} {6517}
5.815557335320482	11236	11440	204	11236	5	0.9909638554216867	GTCCAAAGTACAAAGTGGTCACTGTTCTTC GTCCAAAGTACTCAGTGGTCACTGTTTTTC GTCCAGAGTACACAGTGGTCGCTGTTTTTC GTTCAAAGTACACAGTGGTCACTGTTTTTC GTTCAGAGTACTCAATGGTCTTTGTTCTTC	11410	1	0.9909638554216867	GGTCTACATGCCTGCTAGCTGGGTGATGCG	2	0.9849397590361446	AATGCTTTCTTGCCATTTACTCTTGGTA GAATGCTTTCTTGCCATTCACTCTTGGT	{11278} {11277}
5.834991578646307	9116	9329	213	9116	2	0.9909638554216867	CAGTGCTGTTGGCAATATTTGCTACACACC TAGTGCTGTTGGCAACATTTGCTACACACC	9299	4	0.9909638554216867	AGACACTCGTTATGTGCTTATGGATGGTTC TGACACCCGTTATGTGCTCATGGATGGTTC TGACACTCGCTATGTGCTCATGGACGGTTC TGACACTCGTTATGTGCTTATGGATGGTTC	2	0.9909638554216867	AGGATGCTATGGGCAAACCTGTGCCATA CTCATTGAGTATAGTGATTTTTCTACTT	{9217} {9153}
5.888865756109888	9386	9627	241	9386	4	0.9909638554216867	TGATGCAGAGTACTGCCGTCATGGCACATG TGATGCGGAGTACTGTAGGCATGGTACTTG TGATGCTGAGTACTGTAGACATGGTACATG TGATGCTGAGTATTGCAGACATGGTACTTG	9597	2	0.9909638554216867	GGTGGTATTATCGCCATACTGGTGACTTGT GGTGGTATTATTGCCATATTGGTGACTTGT	2	0.9819277108433735	GCTCTAGATGTGTCTGCTTCAGTAGTAG TCTGTGGTGTTGATGCGATGAATCTCAT	{9567} {9502}
5.892388504066714	5631	5874	243	5631	4	0.9909638554216867	AGAAACTATGACCCATCTTCTACAACATGC AGAAACTATGACCCATCTTCTACAGCATGC AGAAACTATGACCCATCTTTTACAGCATGC AGAAACTATGACTCATCTTTTACAGCACGC	5844	2	0.9909638554216867	AGAGTCACCTTTTGTTATGATGTCTGCACC AGAGTCTTCTTTTGTTATGATGTCTGCACC	2	0.9819277108433735	AGCTGTGATGTATATGGGTACTCTATCT TTATGATGAGCTTAAGACAGGTGTTTCA	{5742} {5769}
5.892388504066714	18313	18556	243	18313	3	0.9909638554216867	ACAGGCACCGACACACCTCAGTGTTGATAC ACAGGCACCTACACACCTCAGCGTTGATAT ACAGGCACCTACACATCTCAGTGTTGATAC	18526	3	0.9909638554216867	GGGCTGTCATGCAACTAGAGATGCTGTGGG GGGTTGTCATGCAACAAGGGATGCTGTGGG GGGTTGTCATGCTACTAGAGATGCTGTAGG	2	0.9879518072289156	CGAAGAAGCTATTCGTCACGTTCGTGCG CGTGAAGAAGCCATTCGTCACGTTCGTG	{18478} {18476}
5.893870128054923	5851	6041	190	5851	2	0.9909638554216867	ACTTTTGTTATGATGTCAGCACCACCGTCT TCTTTTGTTATGATGTCTGCACCACCTGCT	6011	4	0.9909638554216867	CCTCTGAGTACAAAGGTTCTATTACAGATG TGTCAGAATATAAAGGACCAGTGACTGATG TGTCAGAGTACAAAGGACCAGTGACTGATG TGTCAGAGTATAAGGGACCAGTGACTGATG	3	0.9879518072289156	GAATACAAATTACAGCAAGGTACATTCT GAGTACAAATTACAACAGGGGGCCTTTT GAGTATAAATTACAGCAAGGTACATTCT	{5881} {5881} {5881}
5.894135466635868	6326	6570	244	6326	3	0.9909638554216867	CAGACTTGAATGGCGATGTAGTGGCTATTG CCGACTTGAATGGAGATGTAGTGGCTATTG CTGACTTAAATGGTGATGTAGTGGCTATTG	6540	3	0.9909638554216867	CACACAAGGAATGGACAATCTTGCTTGTGA CACACAGGGAATGGATAATCTTGCCTGTGA CGCACAAGGAATGGAAACTCTTGCTTGTGA	2	0.9819277108433735	ACTCCACGAGTTTCAAGAAAGGTGCAAA CTATAGACACTATTCAGCGAGTTTCAAG	{6368} {6357}
5.894135466635868	26287	26531	244	26287	5	0.9909638554216867	GTTATTCCGAGGATTGGCATTCAGGTGTAA GTTATTCTGAGAATTGGCACTCAGGTGTTA GTTATTCTGAGGATAGGCACTCAGGTGTTA GTTATTCTGAGGATTGGCATTCAGGTGTTA GTTTTGTAGAAAAATGGGAGTCTGGTGTCA	26501	1	0.9909638554216867	AATGGATCCAATTTATGATGAGCCGACGAC	2	0.9849397590361446	AAGACTATGTAGTAATACATGGCTATTT CATGGCTATTTCGCCGAAGTTCACTACC	{26317} {26334}
5.902730266661922	943	1192	249	943	5	0.9909638554216867	GGCAAATCGATGTGCACTCTTTCTGAACAA GGCAAATCTTGTGCTCCACTCTCTGACCAA GGCAAGTCAATGTGCACTCTTTCCGAACAA GGTAAGTCGATGTGCACTCTTTCCGAACAA GGTAAGTCTATGTGCACTCTTTCTGAACAA	1162	1	0.9909638554216867	GTCAAAGTCATTCAACCACGTGTTGAAAAG	2	0.9819277108433735	CTTGATTACATCGAGTCGAAGAGAGGTG CTTGATTTCATTGAATCGAAGCGTGGTG	{973} {973}
5.915328706359163	1293	1492	199	1293	3	0.9909638554216867	CCATTGTGGTGAAACTTCATGGCAGACGGG TCATTGCGATGAAGTTTCATGGCAGACGTG TCATTGTGATGAAGCTTCTTGGCAGACGTG	1462	3	0.9909638554216867	CCAGAGCATAGTGTTGCTGACTACCACAAC CCTGAGCATAGTGTTGCAGACTACCACAAC CCTGAGCATAGTGTTGCAGATTATCACAAC	3	0.9849397590361446	CGACTTTCTGAGAGCCACTTGTGAACAT TGAATATTGTGGCACTGAAAATCCAGTG TGTGAAGGACCCACTACATGTGGATACC	{1323} {1344} {1372}
5.92217380995394	9665	9867	202	9665	2	0.9909638554216867	TGAATACAACCATGTTGTTGCTGCCAATGC TGAGTACAACCATGTTGTTGCTGCTAATGC	9837	4	0.9909638554216867	GGTTATGTTCACACCCTTAGTGCCTTTCTG TGCCATGTTTTCTCCAATCGTGCCTTTCTG TGCCATGTTTTCTCCTATTGTGCCTTTTTG TGCTATGTTTTCTCCCATTGTGCCTTTCTG	3	0.9849397590361446	ACCAGCTTACAGCTTTCTGCCGGGAGTC CACCTGCTTATAGCTTTTTGCCAGGAGT CTCTGTTTGGCACCTGCCTATAGTTTTT	{9734} {9733} {9723}
5.960043765448654	4428	4601	173	4428	4	0.9909638554216867	CGGACAAGGATGTGCTGGTTATACACTCGA CGGTCAAGGTTGTGCTGGTTATACACTTGA TGGACAAGGATGTGCTGGTTATACACTTGA TGGTCAGGGTTTAAATGGTTACACTGTAGA	4571	2	0.9909638554216867	ATGCTTGCTCATGCAGAGGAGACAAGAAAA ATGCTTGCTCATGCTGAAGAGACAAGAAAA	4	0.9819277108433735	AAAATGCAAATCTGCACTGTATGTTCTA ACTGCGCTTAGAAAATGCAAGTCTGTGT CTGCGCTTAAAAGGTGCAAATCTGCATG GAAATGCAAATCTGCATTTTATGTACTA	{4480} {4469} {4470} {4480}
5.979866666009797	12653	12883	230	12653	3	0.9909638554216867	GACTACAGCAGCCAAACTCATGGTTGTTGT TACAACAGCAGCCAAACTCATGGTTGTTGT TACAACAGCAGCTAAACTCATGGTTGTTGT	12853	3	0.9939759036144579	TAAGAGCCAACTCAGCTGTTAAACTACAGA TAAGAGCCAATTCAGCTGTCAAACTACAGA TAAGGGCCAATTCAGCTGTCAAATTACAGA	3	0.9909638554216867	ACCTGATTATGGAACCTACAAGAATACT GTAACACTTTCACATATGCGTCAGCACT TCAAATTTGGCTTGGCCTCTTATTGTTA	{12683} {12718} {12819}
5.983616028494806	26919	27151	232	26919	4	0.9909638554216867	GGAACTTTAACATTGCTTATCATGGCAGAC GGAACTTTAACATTGCTTATCATGGCTGAG GGAACTTTAACATTGCTTGTCATGGCAGAG GGAACTTTAATTTTAGCCATGTCAGGTGAC	27121	2	0.9939759036144579	TTGCTTGCTTTGTGCTTGCTGCTGTTTACA TTGCTTGTTTTGTGCTTGCTGCTGTCTACA	3	0.9849397590361446	GGTTTCATTTTCCTTGCCTGGATTATGT TTATGTTATTACAATTTGCCTATTCTAA TTGTTTTCCTGTGGCTCTTGTGGCCAGT	{27009} {27031} {27088}
5.983716028494807	7508	7611	103	7508	4	0.9909638554216867	TGCCAGTCATTTCATTAGCAATTCTTGGCT TGCTAGTCATTTCATCAGCAACTCATGGCT TGCTAGTCATTTCATCAGCAATTCTTGGCT TTCAACACATTTTGCTAGTGGTTCATGGCT	7581	3	0.9909638554216867	GCAATGGTTAGGATGTACATCTTCTTTGCT GCAATGGTTAGGATGTACATTTTCTTCGCT GCTATGGTCAGGATGTACATTTTCTTTGCT	1	0.9819277108433735	CATTAGTATTGTACAAATGGCACCCGTT	{7550}
6.010419948987033	21228	21475	247	21228	5	0.9909638554216867	TGTGCAACAGTACATACGGCTAATAAATGG TGTGCAACTGTACATACAGCTAACAAATGG TGTGCCACAGTACATACAGCTAACAAATGG TGTGCCACTGTACATACAGCTAATAAATGG TGTGCTACTGTACATACAGCTAATAAGTGG	21445	1	0.9909638554216867	TCTCATGGTGGACAGCTTTTGTTACAAATG	3	0.9759036144578314	AAACATGTGACAAGAGAGAATGACTCAA AAACATGTGTTAAAGGATAATGACTCAA TCACTTATCTGTGTGGATTTATAAAGCA	{21294} {21294} {21334}
6.0255885273624	9581	9690	109	9581	5	0.9909638554216867	AGCTTCTGTAGTAGCGGGTGGTATCATTGC TGCATCTATTGTAGCAGGTGGTGTTGTAGC TGCTTCAGTAGTAGCAGGTGGTATTATTGC TGCTTCAGTAGTGGCTGGTGGTATTATTGC TGCTTCTGTAGTGGCGGGTGGTATTATTGC	9660	2	0.9909638554216867	TTTGGTGAATACAACCATGTTGTTGCTGCC TTTGGTGAGTACAACCATGTTGTTGCTGCT	1	0.9849397590361446	CATATTGGTGACTTGTGCTGCTTACTAC	{9611}
6.0255885273624	18721	18830	109	18721	4	0.9909638554216867	ACCCTGGAACATAGTGCGTATCAAGATAGT GCCCTGGAACGTGGTGCGTATTAAGATTGT GCCCTGGAATGTAGTGCGTATTAAGATAGT GCCCTGGAATGTTGTGCGTATTAAGATCGT	18800	3	0.9939759036144579	GTCCTCTGGGCACATGGCTTTGAACTCACA GTCCTTTGGGCACATGGCTTTGAACTTACA GTCCTTTGGGCGCATGGCTTTGAGCTTACA	1	0.9879518072289156	CTGAAAGGATTGTCAGACAGAGTCGTGT	{18770}
6.037857335320482	28607	28703	96	28607	2	0.9909638554216867	CGTGCAAGATCAGTTTCACCAAAACTTTTC CGTGCGAGATCAGTTTCACCCAAACTGTTT	28673	5	0.9909638554216867	CCACTTTTCCTCATTGTTGCTGCATTAGTA CCACTTTTTCTCATTGTTGCTGCTCTAGTA CCGCTTTTTCTCATTGTTGCTGCTTTAGTA CCGCTTTTTCTCATTGTTGCTGTTCTAGTA CCTGTTTTCCTTATCGTTGCAGCTATAGTG	2	0.9879518072289156	ACAAGAGGAAGTTCACCAAGAGCTCTAC ACAAGAGGAGGTTCAACAAGAGCTCTAC	{28642} {28642}
6.079448055426138	11473	11697	224	11473	5	0.9909638554216867	CTTATCTGGTTATCGGCTCAAAGACTGTGT CTTGTCTGGTTATAGGCTTAAGGATTGTGT CTTGTCTGGTTATCGGCTTAAGGACTGTGT TTTGTCTGGTTATCGGCTCAAGGACTGTGT TTTGTCTGGTTTCAAGCTAAAGGACTGTGT	11667	1	0.9909638554216867	TTTCTGTAACCTCTAACTATTCTGGTGTCG	4	0.9849397590361446	CTTAGTTTTGCTTATCCTCATGACTGCC GCGTGTATGGACATTGATGAATGTCATT TAGTTTTGCTTGTCCTCATGACAGCTCG TTTAGTTTTGCTTTTTCTCATGACAGCT	{11518} {11572} {11520} {11518}
6.089075410741901	19095	19324	229	19095	2	0.9939759036144579	TCCATGAGTGCTTCGTTAAGCGCGTCGATT TCCATGAGTGCTTTGTTAAGCGCGTTGATT	19294	4	0.9939759036144579	GAAATTCTACGACGCTCAGCCTTGCAGTGA GAAGTTCTACGATGCTCAGCCATGCAGTGA GAAGTTCTACGATGCTCAGCCATGTAGTGA GAAGTTCTATGATGCTCAGCCATGCAGTGA	4	0.9909638554216867	ATTATAGGAGATGAACTGAGGGTTAATT GAGATGAACTGAAGATTAATTCCGCTTG GGTCTGTTGAATATCCGATTATCGGAGA TTAAATGTGTGCCACAGGCTGAAGTGGA	{19142} {19149} {19125} {19263}
6.0909666660097965	20128	20273	145	20128	2	0.9909638554216867	AATAGGTGTCTGCACAATGACTGACATTGC AATAGGTGTCTGTACAATGACTGACATAGC	20243	4	0.9909638554216867	CGCCCGTAATGGTGTTTTAATAACAGAAGG TGCACGTAATGGTGTTTTAATAACGGAAGG TGCCCGAAACGGTGTTTTAATAACAGAAGG TGCTCGCAATGGTGTTTTAATAACAGAAGG	6	0.9879518072289156	AGAGTGCTTGTTCCTCACTTACAGTCTT AGTGCTTGTTCATCACTTACCGTCTTGT CTGAAAGCACTTGCTCGTCGCTTACTGT CTGAAAGCGCTTGTTCGTCGCTTACTGT CTGAGAGTGCTTGTTCCTCGCTTACTGT TGAGAGTGCTTGTTCATCACTCATTGTC	{20172} {20174} {20169} {20169} {20169} {20170}
6.109389758004454	13784	13889	105	13784	3	0.9909638554216867	TCCTAAAAACTAATTGCTGCCGATTCCAGG TCCTAAAAACTAATTGCTGTCGCTTCCAGG TCCTAAAGACTAATTGCTGCCGCTTCCAAG	13859	4	0.9939759036144579	AGAGACACACGATGTCCAACTACCAACATG AGAGACATACTATGTCCAACTACCAGCATG AGAGGCACACAATGTCCAACTACCAACATG AGAGGCATACTATGTCTAACTACCAACATG	2	0.9909638554216867	AGAAGGATGAAGAAGGCAATTTAATAGA AGAAGGATGAGGAAGGCAATTTATTAGA	{13814} {13814}
6.15573770537095	9095	9207	112	9095	2	0.9909638554216867	GCATTTTCTACCTCGCGTTTTTAGTGCCGT GCATTTTCTACCTCGTGTTTTTAGTGCTGT	9177	5	0.9909638554216867	ACATCGGCATGCGTTTTAGCTGCTGAATGT ACCTCTGCTTGCGTTCTTGCTGCTGAGTGT ACTTCTGCTTGCGTCTTAGCAGCTGAGTGT ACTTCTGCTTGCGTCTTGGCTGCGGAATGT ACTTCTGCTTGCGTTTTGGCTGCTGAATGT	2	0.9849397590361446	ACCATCTAAACTCATTGAGTATAGTGAT TTGCTACACACCTTCCAAACTCGTTGAG	{9143} {9134}
6.166289493487165	20439	20575	136	20439	3	0.9909638554216867	GGACTTCAAACCCAGATCAAAAATGGAGAC GGATTTCAAGCCCAGGTCACAAATGGAGAC GGATTTTAAGCCCAGATCACAAATGGAAAC	20545	4	0.9909638554216867	TATGGAGACTTTAGTCATGGACAGCTTGGT TATGGAGATTTCAGTCATGGACAACTTGGC TATGGAGATTTCAGTCATGGCCAACTTGGT TATGGAGATTTTAGTCATGGACAACTTGGC	1	0.9939759036144579	CTCGAGCTCGCTATGGATGAATTCATAC	{20476}
6.1786000822449525	18855	19073	218	18855	2	0.9909638554216867	GACCTGAAAGAACGTGTTGTCTGTGCGACA GACCTGAAAGAACGTGTTGTCTGTGTGACA	19043	4	0.9909638554216867	GGAAATGCACATGTGGCTAGTTGTGATGCT GGTAACGCCCATGTAGCTAGTTGTGATGCT GGTAACGCTCATGTGGCTAGTTGTGATGCT GGTAATGCTCATGTAGCTAGTTGTGATGCT	5	0.9789156626506024	AGTGGGGCTTTACGGGTAACCTTCGGAG CGTGCGACTTGTTTCTCTACTTCATCTG CTTCATCAGATACTTATGCTTGTTGGAG TGTTTTTCTACTTCATCAGACAATTATG TTCATCTGATACTTATGCCTGTTGGAAT	{18987} {18887} {18906} {18896} {18907}
6.1794942636812	27124	27212	88	27124	2	0.9939759036144579	CTTGCTTTGTGCTTGCTGCTGTTTACAGAA CTTGTTTTGTGCTTGCTGCTGTCTACAGAA	27182	5	0.9909638554216867	CGCAATGGCTTGTATAGTAGGCTTGATGTG TGCAATGGCCTGTCTTGTAGGCTTGATGTG TGCAATGGCCTGTTTAGTGGGGCTTATGTG TGCAATGGCTTGTATCGTAGGCTTGATGTG TGCAATGGCTTGTATTGTAGGCTTGATGTG	4	0.9789156626506024	TCAATTGGGTGACTGGCGGAATTGCGAT TCAATTGGGTGACTGGCGGTATTGCGAT TCAATTGGGTGACTGGTGGGATTGCGAT TTAATTGGGTGACTGGCGGGATTGCGAT	{27154} {27154} {27154} {27154}
6.182732422683973	351	491	140	351	2	0.9909638554216867	AACACACGTCCAACTCAGTTTACCTGTTCT AACACACGTCCAACTCAGTTTGCCTGTCCT	461	5	0.9909638554216867	ATGGAACATGTGGCATTATCAGTCTCCAGA ATGGCACTTGTGGCTTAGTAGAAGTTGAAA ATGGCACTTGTGGTCTAGTAGAGCTGGAAA ATGGCACTTGTGGTTTAGTAGAGCTGGAAA GTGGCACTTGTGGCATAGTAGAGCTGGAAA	1	0.9789156626506024	TCAGGTTAGAGACGTGCTAGTGCGTGGC	{381}
