cost	target-start	target-end	target-length	left-primer-start	left-primer-num-primers	left-primer-frac-bound	left-primer-target-sequences	right-primer-start	right-primer-num-primers	right-primer-frac-bound	right-primer-target-sequences	num-guides	total-frac-bound-by-guides	guide-target-sequences	guide-target-sequence-positions
2.5126942636811997	26734	26822	88	26734	1	1.0	TGGAACCAAAGTTCTCTATTGCTTTGCCTC	26792	1	1.0	TCGCTCTAATAACTCATCTCGTGCTAGCAG	1	1.0	CAGAGCTCTCTGTTGTTGAGTTTGAGGA	{26764}
2.534811090344213	5413	5503	90	5413	1	1.0	GGATGTAAAGCCATATGGTTACCCTAATGA	5473	1	1.0	CACCGACAATAATTGTTGGGTTAATGCAAC	1	1.0	TTGTTGGTGGTTTTAGAGTTCTTGGGAC	{5445}
2.5555	5360	5452	92	5360	1	1.0	GTTGACTGGGTTGCTTTTTACGGTTTTGAA	5422	1	1.0	GCCATATGGTTACCCTAATGATTTTGTTGG	1	1.0	AAGGCAGCACTTTTTGCTTCTTTGGATG	{5390}
2.678729642842771	3017	3124	107	3017	1	1.0	GTTTTTGTTGAACCTAAGGATGGTGGTCAA	3094	1	1.0	TTATCCAGCTTCATGTAATGGTGTATTGCC	1	1.0	TCTGGTGATTATCTTTGGTATGTTGTAG	{3056}
2.7461433771173467	26734	26852	118	26734	1	1.0	TGGAACCAAAGTTCTCTATTGCTTTGCCTC	26822	1	1.0	TCGTTCTTCAACTCGTAACAACTCACGAGA	1	1.0	CAGAGCTCTCTGTTGTTGAGTTTGAGGA	{26764}
2.7971342433258255	26400	26528	128	26400	1	1.0	GCTAGGAAGAAATTTCCTCCTCCTTCATTT	26498	1	1.0	TGGTAAGGGTAATAAAGATGAGCAGATTGG	1	1.0	TGCCTCTTTTGGTTAGTTCTGATAAGGC	{26434}
2.8064266863651715	710	840	130	710	1	1.0	CGAGGTTGGCTCATTTTTTCTAACAGCAAT	810	1	1.0	TGTGTGGTTTTGATGGTAAACCTGTGTTAC	1	1.0	TGATGTTGTTTTTGGCCATGGTGCAGGA	{757}
2.8154573353204815	21941	22073	132	21941	1	1.0	GACGGTTGCATTTGCTACTTTTGTTGATGT	22043	1	1.0	TGAGCACTTGCAGTTTGGATTGCAAGATGG	1	1.0	GCGATTCTCCATTTGAAAAGTTGCAGTG	{22015}
2.8327894934871645	25712	25848	136	25712	1	1.0	GTCCATTTACGTAACTGGAACTTTAGTTGG	25818	1	1.0	AGATGTCTGTTTTATGGTGTTTATGGCCAC	1	1.0	TTTTATAGTTGTGTTGCAGGATGGGCAT	{25759}
2.8411163730311917	27445	27583	138	27445	1	1.0	CATTGGCTGATGATGATTCAGCCATTATAG	27553	1	1.0	CGTTTAGCGCATGATAAGGGTTTAGTCTTA	1	1.0	CAACGAGGTTTTGCATTAAATTGTTTTG	{27482}
2.849232422683972	14635	14775	140	14635	1	1.0	GACTTCTGGTGACGCTAGTACAGCTTATGC	14745	1	1.0	ATGTTAATGTTAGGGATCTACAACGACGTC	1	1.0	GGTTGTTTAGTGTCCCATCAGATTCATG	{14712}
2.8610337616452868	3855	3998	143	3855	1	1.0	GTGATTGTGGTAAAAAGTTTGATGAGCAGG	3968	1	1.0	AAGCTTGTTAGTATGAAAGGTACTGGTGTG	1	1.0	TTGGTTGTTTGTTTTGGATTATGCCTTA	{3885}
2.8834079683607334	3194	3343	149	3194	1	1.0	CCTACCCATAAAGTCAAGCTCATATTTGAG	3313	1	1.0	TCTTACATCTGCAATGAATGTCATTGGGCA	1	1.0	CAGGTGATTGGGAAGGTTTACATGAAGT	{3285}
2.8869897580044537	3648	3798	150	3648	1	1.0	GTACCACACTTGTACAGTTGCAACTTACAA	3768	1	1.0	TTAGTGGTTCACTTGGTGATAGTGGTAAAC	1	1.0	TTTGGATGATTCTATTGAGATGCAATTG	{3682}
2.912914134296109	7830	7959	129	7830	1	1.0	CAAAACAGGGTGCTGGTTTTAAACGTACTT	7929	1	1.0	CAACCACTGTAACTAGCTTTCATGGTTATG	2	1.0	TTTCTATGGTATGTATGTTTATTTGTTG TTTCTGTGGTATGTATGTTTATTTGTTG	{7865} {7865}
2.9142885273623995	26400	26558	158	26400	1	1.0	GCTAGGAAGAAATTTCCTCCTCCTTCATTT	26528	1	1.0	TTATTGGAATGTTCAAGAGCGTTGGCGTAT	1	1.0	TGCCTCTTTTGGTTAGTTCTGATAAGGC	{26434}
2.920764845367944	8048	8208	160	8048	1	1.0	CATGAGGCTAAGTTTGGTGTTGTTACTACT	8178	1	1.0	TTACATTACAGGCTGCTTTTGGAAACACAG	1	1.0	TATAGTTGTTGGTGTTTCAGAGCGTGTT	{8095}
2.923954591467449	25638	25799	161	25638	1	1.0	CCTGTTCCAGCTGAAGTACTAAATGTCTAA	25769	1	1.0	GTGTTGCAGTATGGGCATTATAAGTATAGC	1	1.0	AGTAGTGTGCCTCTTTTAGAGGTTTATG	{25685}
2.923954591467449	26734	26895	161	26734	1	1.0	TGGAACCAAAGTTCTCTATTGCTTTGCCTC	26865	1	1.0	ACTTCAAGACAACAGTCTCGCACTCGTTCT	1	1.0	CAGAGCTCTCTGTTGTTGAGTTTGAGGA	{26764}
2.939443925003943	9858	10024	166	9858	1	1.0	GTGCCAACCTTATGCTATCAGATAATGTTG	9994	1	1.0	GGTTATACAAGTGTTTCTAGTGTTGAGTGC	1	1.0	TTGAATGGTTGTAGGTGGTGGTTGTGTT	{9911}
2.939443925003943	25824	25990	166	25824	1	1.0	CTGTTTTATGGTGTTTATGGCCACTTGTTC	25960	1	1.0	TTTTGTTAATAGTTTCAGACTTTGGCGCCG	1	1.0	TAGCTTTGTCTATTTTTGACTGTTTTGT	{25854}
2.9454360029807227	27445	27613	168	27445	1	1.0	CATTGGCTGATGATGATTCAGCCATTATAG	27583	1	1.0	CACACAATGGTAGGCCAGTGATAGTAAAGT	1	1.0	CAACGAGGTTTTGCATTAAATTGTTTTG	{27482}
2.9570942636811997	2871	3043	172	2871	1	1.0	TAAGTCGTGTAATTCGTAGAGAAAGGTGTG	3013	1	1.0	AACTGTTTTTGTTGAACCTAAGGATGGTGG	1	1.0	ACATGACTTTTCCTTGTGTTAGTTGTGT	{2901}
2.9599437654486547	3855	4028	173	3855	1	1.0	GTGATTGTGGTAAAAAGTTTGATGAGCAGG	3998	1	1.0	TTTGTACAGGATCCAGCACCTATTGACATT	1	1.0	TTGGTTGTTTGTTTTGGATTATGCCTTA	{3885}
2.9627681611474057	5809	5983	174	5809	1	1.0	TTGTCCACACAGACATAAATTGCGTTCACG	5953	1	1.0	TAACGGTCACTATGTAGTTTATGATGCTGC	1	1.0	TGTTAAGTTTGTTAATGGACGTGTTGTT	{5839}
3.0023946961550467	26400	26589	189	26400	1	1.0	GCTAGGAAGAAATTTCCTCCTCCTTCATTT	26559	1	1.0	CGCAGGGGGCAACGTGTTGATTTGCCTCCT	1	1.0	TGCCTCTTTTGGTTAGTTCTGATAAGGC	{26434}
3.0169684256646945	3017	3212	195	3017	1	1.0	GTTTTTGTTGAACCTAAGGATGGTGGTCAA	3182	1	1.0	CATGATGTTGAACCTACCCATAAAGTCAAG	1	1.0	TCTGGTGATTATCTTTGGTATGTTGTAG	{3056}
3.035423411032158	25443	25646	203	25443	1	1.0	CGATTAATTGATGACAATGGCATTGTCCTC	25616	1	1.0	CCAAGATTATATGCAAATAGCACCTGTTCC	1	1.0	CTTGTTATGATATTTTTCTTTGTGTTGG	{25491}
3.0376573353204814	3594	3798	204	3594	1	1.0	GAGATGAATTGGGTGTTCGTGTTTTAGATC	3768	1	1.0	TTAGTGGTTCACTTGGTGATAGTGGTAAAC	1	1.0	TTTGGATGATTCTATTGAGATGCAATTG	{3682}
3.04426719502264	26316	26523	207	26316	1	1.0	GTGTTTTGTCAGAAAGAGAGAAGTTGCTTC	26493	1	1.0	CCTATTGGTAAGGGTAATAAAGATGAGCAG	1	1.0	TGCCTCTTTTGGTTAGTTCTGATAAGGC	{26434}
3.0444377053709504	7830	7994	164	7830	1	1.0	CAAAACAGGGTGCTGGTTTTAAACGTACTT	7964	1	1.0	AAGTACATTGAGAATGGTCAGTTGAAGGTG	2	1.0	TTTCTATGGTATGTATGTTTATTTGTTG TTTCTGTGGTATGTATGTTTATTTGTTG	{7865} {7865}
3.048599245246692	27360	27569	209	27360	1	1.0	CCCAGTTCTATCAAAGAAATGCAGTCACAA	27539	1	1.0	GTTGCAACCCCATGCGTTTAGCGCATGATA	1	1.0	CAACGAGGTTTTGCATTAAATTGTTTTG	{27482}
3.0507435130281846	25638	25848	210	25638	1	1.0	CCTGTTCCAGCTGAAGTACTAAATGTCTAA	25818	1	1.0	AGATGTCTGTTTTATGGTGTTTATGGCCAC	1	1.0	AGTAGTGTGCCTCTTTTAGAGGTTTATG	{25685}
3.0528735330780323	7997	8208	211	7997	1	1.0	GAAGCACCTTTACACTGTGTTCGTAATGTT	8178	1	1.0	TTACATTACAGGCTGCTTTTGGAAACACAG	1	1.0	TATAGTTGTTGGTGTTTCAGAGCGTGTT	{8095}
3.0612548428519353	26734	26949	215	26734	1	1.0	TGGAACCAAAGTTCTCTATTGCTTTGCCTC	26919	1	1.0	CTTGTTGCTGCTGTTACTTTGGCTTTAAAG	1	1.0	CAGAGCTCTCTGTTGTTGAGTTTGAGGA	{26764}
3.0633163730311916	3452	3668	216	3452	1	1.0	GTTGTTGAAGCGAGCACTGATTTTCATCAA	3638	1	1.0	TGTTGGATTAGTACCACACTTGTACAGTTG	1	1.0	TTTCTTTTTCTTTTAGAGATGAATTGGG	{3579}
3.0681942636811996	3452	3624	172	3452	1	1.0	GTTGTTGAAGCGAGCACTGATTTTCATCAA	3594	1	1.0	GAGATGAATTGGGTGTTCGTGTTTTAGATC	2	1.0	GATATAATTGAACAACCTTTTGGGGAAG GTGCTCTCAATTAGACAACCTTTTTCTT	{3521} {3557}
3.069422592664184	10703	10922	219	10703	1	1.0	GTGCCATTGTTTTTAGGTTGTCACGTTTGA	10892	1	1.0	AGGTGAGTGCTGCTGAATTTAAATACATGG	1	1.0	CCTGAAAGTGTATTTAGTGTTTTTGGTG	{10747}
3.069422592664184	14556	14775	219	14556	1	1.0	GCTTGGTAATGAGTTGGCACAAGTTTTAAC	14745	1	1.0	ATGTTAATGTTAGGGATCTACAACGACGTC	1	1.0	GGTTGTTTAGTGTCCCATCAGATTCATG	{14712}
3.069422592664184	25771	25990	219	25771	1	1.0	GTTGCAGTATGGGCATTATAAGTATAGCAG	25960	1	1.0	TTTTGTTAATAGTTTCAGACTTTGGCGCCG	1	1.0	TTAGCTTTGTCTATTTTTGACTGTTTTG	{25853}
3.069422592664184	25824	26043	219	25824	1	1.0	CTGTTTTATGGTGTTTATGGCCACTTGTTC	26013	1	1.0	ATCCTGAAACTAATGCAATCATCTCTCTCC	1	1.0	TAGCTTTGTCTATTTTTGACTGTTTTGT	{25854}
3.071432422683972	9858	10078	220	9858	1	1.0	GTGCCAACCTTATGCTATCAGATAATGTTG	10048	1	1.0	GGTGTTAGTGTTGAACAATTGTTAGCTTCC	1	1.0	TTGAATGGTTGTAGGTGGTGGTTGTGTT	{9911}
3.071432422683972	26619	26839	220	26619	1	1.0	CCTCATAAGGACCTTAAATTCAGACAACGT	26809	1	1.0	CTCGTGCTAGCAGTCGTTCTTCAACTCGTA	1	1.0	CAGAGCTCTCTGTTGTTGAGTTTGAGGA	{26764}
3.0734297303170677	710	931	221	710	1	1.0	CGAGGTTGGCTCATTTTTTCTAACAGCAAT	901	1	1.0	TGGTGTCACTTATCAACTAGCATGGGATGT	1	1.0	TGATGTTGTTTTTGGCCATGGTGCAGGA	{757}
3.0734297303170677	3777	3998	221	3777	1	1.0	CACTTGGTGATAGTGGTAAACTTCTTAGTG	3968	1	1.0	AAGCTTGTTAGTATGAAAGGTACTGGTGTG	1	1.0	GTAAAAAGTTTGATGAGCAGGTTGGTTG	{3864}
3.0734297303170677	9786	10007	221	9786	1	1.0	CTCATGTTGGTTCTGATTTTACTGGTAGTG	9977	1	1.0	AATGGGCTATGGCTAATGGTTATACAAGTG	1	1.0	TTGAATGGTTGTAGGTGGTGGTTGTGTT	{9911}
3.0754146706409635	2902	3124	222	2902	1	1.0	CATGACTTTTCCTTGTGTTAGTTGTGTCAC	3094	1	1.0	TTATCCAGCTTCATGTAATGGTGTATTGCC	1	1.0	TCTGGTGATTATCTTTGGTATGTTGTAG	{3056}
3.0812967960054203	24884	25109	225	24884	1	1.0	CCTGTTACTACACTTAGTACTATCACTGCT	25079	1	1.0	ACGCTGTTGTTTCGATTCATACATGTTGGC	1	1.0	TGCCTTTATTGGTTCTTTTTGGTATGTA	{25023}
3.0889754107419014	26400	26629	229	26400	1	1.0	GCTAGGAAGAAATTTCCTCCTCCTTCATTT	26599	1	1.0	TTTATTACCTAGGTACTGGACCTCATAAGG	1	1.0	TGCCTCTTTTGGTTAGTTCTGATAAGGC	{26434}
3.09647439218088	5413	5646	233	5413	1	1.0	GGATGTAAAGCCATATGGTTACCCTAATGA	5616	1	1.0	TAACTATGTCTTCAAAGGGTCAAAAGGGTG	1	1.0	TTGTTGGTGGTTTTAGAGTTCTTGGGAC	{5445}
3.098322044777587	3855	4089	234	3855	1	1.0	GTGATTGTGGTAAAAAGTTTGATGAGCAGG	4059	1	1.0	CTGTATATTTAGGTGTTAAGGGTTCTGGTC	1	1.0	TTGGTTGTTTGTTTTGGATTATGCCTTA	{3885}
3.103801953228442	3648	3885	237	3648	1	1.0	GTACCACACTTGTACAGTTGCAACTTACAA	3855	1	1.0	GTGATTGTGGTAAAAAGTTTGATGAGCAGG	1	1.0	TTTGGATGATTCTATTGAGATGCAATTG	{3682}
3.103801953228442	26316	26553	237	26316	1	1.0	GTGTTTTGTCAGAAAGAGAGAAGTTGCTTC	26523	1	1.0	ATTGGTTATTGGAATGTTCAAGAGCGTTGG	1	1.0	TGCCTCTTTTGGTTAGTTCTGATAAGGC	{26434}
3.1074038657081178	27360	27599	239	27360	1	1.0	CCCAGTTCTATCAAAGAAATGCAGTCACAA	27569	1	1.0	AGGGTTTAGTCTTACACACAATGGTAGGCC	1	1.0	CAACGAGGTTTTGCATTAAATTGTTTTG	{27482}
3.1109657561098882	3102	3343	241	3102	1	1.0	CTTCATGTAATGGTGTATTGCCAGTTGCTT	3313	1	1.0	TCTTACATCTGCAATGAATGTCATTGGGCA	1	1.0	CAGGTGATTGGGAAGGTTTACATGAAGT	{3285}
3.1144885040667143	597	840	243	597	1	1.0	GCTTACAGGATTGTGTAACCGGTATTAATG	810	1	1.0	TGTGTGGTTTTGATGGTAAACCTGTGTTAC	1	1.0	TGATGTTGTTTTTGGCCATGGTGCAGGA	{757}
3.1197010878282048	26734	26980	246	26734	1	1.0	TGGAACCAAAGTTCTCTATTGCTTTGCCTC	26950	1	1.0	ACTTAGGTTTTGATAACCAGTCGAAGTCAC	1	1.0	CAGAGCTCTCTGTTGTTGAGTTTGAGGA	{26764}
3.123129642842771	14635	14883	248	14635	1	1.0	GACTTCTGGTGACGCTAGTACAGCTTATGC	14853	1	1.0	TTTCAATGATGATTCTCTCTGATGACGGTG	1	1.0	GGTTGTTTAGTGTCCCATCAGATTCATG	{14712}
3.1248302666619225	10703	10952	249	10703	1	1.0	GTGCCATTGTTTTTAGGTTGTCACGTTTGA	10922	1	1.0	TTGCTAATGGACTTCATGCACCACATGGAC	1	1.0	CCTGAAAGTGTATTTAGTGTTTTTGGTG	{10747}
3.1265219161711366	26619	26869	250	26619	1	1.0	CCTCATAAGGACCTTAAATTCAGACAACGT	26839	1	1.0	ACAACTCACGAGACTCTTCTCGTAGCACTT	1	1.0	CAGAGCTCTCTGTTGTTGAGTTTGAGGA	{26764}
3.1280684256646945	7830	8025	195	7830	1	1.0	CAAAACAGGGTGCTGGTTTTAAACGTACTT	7995	1	1.0	TTGAAGCACCTTTACACTGTGTTCGTAATG	2	1.0	TTTCTATGGTATGTATGTTTATTTGTTG TTTCTGTGGTATGTATGTTTATTTGTTG	{7865} {7865}
3.180522592664184	12436	12655	219	12436	1	1.0	CACCCTAGTATGGATGGTTACTGTAAGTTT	12625	1	1.0	GGGGTTCTAGTGCAGCTCGACTAGAACCCT	2	1.0	GTTCAGGTTCCTATTGGTTGTTTGGATC TGGTTGTTGGTTGGGACACGGGTGTGCT	{12478} {12546}
3.214901953228442	7830	8067	237	7830	1	1.0	CAAAACAGGGTGCTGGTTTTAAACGTACTT	8037	1	1.0	TTAATCAATGGCATGAGGCTAAGTTTGGTG	2	1.0	TTTCTATGGTATGTATGTTTATTTGTTG TTTCTGTGGTATGTATGTTTATTTGTTG	{7865} {7865}
3.232519948987033	7712	7959	247	7712	1	1.0	CTTTCTCAAGAGGGTAAGAAGTACCTTGTT	7929	1	1.0	CAACCACTGTAACTAGCTTTCATGGTTATG	2	1.0	TTTCTATGGTATGTATGTTTATTTGTTG TTTCTGTGGTATGTATGTTTATTTGTTG	{7865} {7865}
3.2359302666619225	12436	12685	249	12436	1	1.0	CACCCTAGTATGGATGGTTACTGTAAGTTT	12655	1	1.0	GTAATGGCACGGACATCGATAAGTGTGTTC	2	1.0	GTTCAGGTTCCTATTGGTTGTTTGGATC TGGTTGTTGGTTGGGACACGGGTGTGCT	{12478} {12546}
3.3521786676602408	10154	10262	108	10154	1	1.0	CTGAAGTTGTGAAGCAGATGTATGGTGTTA	10232	2	1.0	TTAGCATTTTCTTCACAATGTTCTGGGCAG TTAGCGTTTTCTTCACAATGTTTTGGGCAG	1	1.0	ACTTGCAAAGTGGTAAGGTTATTTTTGG	{10184}
3.3652648453679435	22023	22133	110	22023	1	1.0	CCATTTGAAAAGTTGCAGTGTGAGCACTTG	22103	2	1.0	TGTTTTGCCTGAGACTTATGTTGCACTCCC TGTTTTGCCTGATACTTATGTTGCACTTCC	1	1.0	CAGTTTGGGTTGCAAGATGGTTTTTATT	{22053}
3.6091539643783346	22023	22190	167	22023	1	1.0	CCATTTGAAAAGTTGCAGTGTGAGCACTTG	22160	2	1.0	TTTTACTGCAACTGCATCTTTTGGTGGTTC TTTTACTGCGACTGCTTCTTTTGGTGGTTC	1	1.0	CAGTTTGGGTTGCAAGATGGTTTTTATT	{22053}
3.6589972680519156	10077	10262	185	10077	1	1.0	CATTCAACATCTTCATGAAGGTTTTGGTGG	10232	2	1.0	TTAGCATTTTCTTCACAATGTTCTGGGCAG TTAGCGTTTTCTTCACAATGTTTTGGGCAG	1	1.0	ACTTGCAAAGTGGTAAGGTTATTTTTGG	{10184}
3.674026590941621	649	840	191	649	2	1.0	GACTGGTACCAATCAGCTTTGTGCCAAAAT GACTGGTACTAATCAGCTCTGTGCCAAAAT	810	1	1.0	TGTGTGGTTTTGATGGTAAACCTGTGTTAC	1	1.0	TGATGTTGTTTTTGGCCATGGTGCAGGA	{757}
3.676464373321448	21941	22133	192	21941	1	1.0	GACGGTTGCATTTGCTACTTTTGTTGATGT	22103	2	1.0	TGTTTTGCCTGAGACTTATGTTGCACTCCC TGTTTTGCCTGATACTTATGTTGCACTTCC	1	1.0	GCGATTCTCCATTTGAAAAGTTGCAGTG	{22015}
3.702123411032158	3855	4058	203	3855	1	1.0	GTGATTGTGGTAAAAAGTTTGATGAGCAGG	4028	2	1.0	GATGCTTTCCCTGTGAAACCTATATGTTCA GATGCTTTCCCTGTTAGACCTATATGTTCA	1	1.0	TTGGTTGTTTGTTTTGGATTATGCCTTA	{3885}
3.7291181283451795	1041	1211	170	1041	2	1.0	CCAAGCCGCCTAAATATTCTTCTAAGGTTG CCAAGCCTCCTAAATATTCATCTAAGGTTG	1181	1	1.0	GTTAAATGCAATTGTGGTTCTGAGAGTTGG	2	1.0	GGTGAATGGAATGCTGTGTATAGGGCGT GTGGTGAATGGAATGCTGTGTATAAGGC	{1079} {1077}
3.7881199489870325	8613	8860	247	8613	1	1.0	CTTTTAGCGTTGTGGCTATGTCTGGACATA	8830	2	1.0	TGTTTCTACTAGGACAGTGCGTTATGCCTC TGTTTTTACTAGGACAGTGCGTTATGCTTG	1	1.0	TGTTGTTTAATTTTCTTTTTGCAGCATT	{8643}
3.7898296428427707	21825	22073	248	21825	2	1.0	GAAATTGTTGTTGCTAGAACTGGCCAGTTT GAGATTGTTGTTGCTAGAACTGGTCAGTTT	22043	1	1.0	TGAGCACTTGCAGTTTGGATTGCAAGATGG	1	1.0	GCGATTCTCCATTTGAAAAGTTGCAGTG	{22015}
3.791530266661922	21941	22190	249	21941	1	1.0	GACGGTTGCATTTGCTACTTTTGTTGATGT	22160	2	1.0	TTTTACTGCAACTGCATCTTTTGGTGGTTC TTTTACTGCGACTGCTTCTTTTGGTGGTTC	1	1.0	GCGATTCTCCATTTGAAAAGTTGCAGTG	{22015}
3.857148055426138	1041	1265	224	1041	2	1.0	CCAAGCCGCCTAAATATTCTTCTAAGGTTG CCAAGCCTCCTAAATATTCATCTAAGGTTG	1235	1	1.0	TTATCTTCTTGTTGTGGCACACCTGCTAAG	2	1.0	GGTGAATGGAATGCTGTGTATAGGGCGT GTGGTGAATGGAATGCTGTGTATAAGGC	{1079} {1077}
4.389936002980723	12436	12604	168	12436	1	1.0	CACCCTAGTATGGATGGTTACTGTAAGTTT	12574	3	1.0	TGTGACCGTACAACTATTCAAAGTGTCGAT TGTGACCGTACAACTATTCAAAGTGTTGAC TGTGATCGTACAACCATTCAAAGTGTTGAC	2	1.0	GTTCAGGTTCCTATTGGTTGTTTGGATC TGGTTGTTGGTTGGGACACGGGTGTGCT	{12478} {12546}
