cost	target-start	target-end	target-length	left-primer-start	left-primer-num-primers	left-primer-frac-bound	left-primer-target-sequences	right-primer-start	right-primer-num-primers	right-primer-frac-bound	right-primer-target-sequences	num-guides	total-frac-bound-by-guides	guide-target-sequences	guide-target-sequence-positions
2.5126942636811997	1001	1089	88	1001	1	1.0	GTGACTTTGATATTGTAGTGGCTTGGCATG	1059	1	1.0	CCTGCAGACTATAGCTACTATTTGTGGTAT	1	1.0	TAGTTCGTGATTCACGATTTGTTATGCG	{1031}
2.5126942636811997	1322	1410	88	1322	1	1.0	ATGGTTGGGTTTCAGGTAATATGATGGATG	1380	1	1.0	TTATGACTCTAGCGAAGTTAAAGCCCAATC	1	1.0	GTTTTTCTTGTCCATTGTGTTGTACAGT	{1352}
2.5932573353204815	498	594	96	498	1	1.0	GTCCGGTACGGCAATTTTAATTAAATCACC	564	1	1.0	TATGGGCTTGTTCCGTTCATACAAGACTAA	1	1.0	GCTTGGGTGGTTTTCCTAAAGGGTATGT	{536}
2.6920885273623996	9273	9382	109	9273	1	1.0	CCCTTTTCACTTAAAGGAGGTGTTGTATTG	9352	1	1.0	TATTGTGGGCTTTACTGCCTACATATAGTG	1	1.0	AGTAATTTGTTATATATATTATTTTTTG	{9303}
2.7405681611474058	891	1008	117	891	1	1.0	AGACCAGTATGGTTGTGACTATTCTGGTAA	978	1	1.0	GCAGTCTGTATGGCTTGCCAATTGTGACTT	1	1.0	ATTAGCAGATTGTCTTCAAGCTTATGGT	{921}
2.7405681611474058	1257	1374	117	1257	1	1.0	GTGTGATTGTGGTTTTGTTATGCAGTATGG	1344	1	1.0	GATGGATGGTTTTTCTTGTCCATTGTGTTG	1	1.0	ATTGTGATTTTTATGGTTGGGTTTCAGG	{1310}
2.7405681611474058	2914	3031	117	2914	1	1.0	GAGGCTGGTGATGAAGCAATGGCCTCTCGT	3001	1	1.0	GAAGATACTATTGATGGTGTCGTTGAAGAC	1	1.0	ATGTATTGTACTTTTGCTATTGAGGATG	{2944}
2.7875643733214486	1001	1127	126	1001	1	1.0	GTGACTTTGATATTGTAGTGGCTTGGCATG	1097	1	1.0	TTGCACAACCTACAGAAGATGTAGTAGATG	1	1.0	TAGTTCGTGATTCACGATTTGTTATGCG	{1031}
2.7875643733214486	8863	8989	126	8863	1	1.0	GAGAGGGTGTGCAATTAGAAAAGGTTTTAG	8959	1	1.0	CTAAATCTATGATATCTGCAGTAGCTGCTG	1	1.0	ATACTTTTGTGGGATGTGTACGTAAATG	{8893}
2.801814134296109	20896	21025	129	20896	1	1.0	CCCACAAGGTAATCTAGGTGGTAATTGCGC	20995	1	1.0	TTTTGAACCTCGCTCAGATTTAGAACGGGA	1	1.0	TCTTTACTCAGAGTCGTGTATTGTCAAG	{20967}
2.81987901698314	2665	2798	133	2665	1	1.0	GTTATGGAGATTCCGTCTTTGATGACAGTT	2768	1	1.0	AGGGTGTTACTGTAGATGATTTTGTTGCTG	1	1.0	AGGTTATGTTTGATTTAGATTCTACTTT	{2696}
2.8532146706409636	6983	7124	141	6983	1	1.0	GCCTGTTATTTGGTTTTGTCATGATGAAGC	7094	1	1.0	ATCTGAGGAGTCACAAGGTAATGTGGTTAC	1	1.0	GATATAGTGTTTTGTCTGTTGATTCTGT	{7066}
2.8724160284948064	9273	9419	146	9273	1	1.0	CCCTTTTCACTTAAAGGAGGTGTTGTATTG	9389	1	1.0	GTCTGATATTCATTTGCCTGCTTATGCTAG	1	1.0	AGTAATTTGTTATATATATTATTTTTTG	{9303}
2.876122044777587	891	1038	147	891	1	1.0	AGACCAGTATGGTTGTGACTATTCTGGTAA	1008	1	1.0	TGATATTGTAGTGGCTTGGCATGTAGTTCG	1	1.0	ATTAGCAGATTGTCTTCAAGCTTATGGT	{921}
2.8797857056612073	1257	1405	148	1257	1	1.0	GTGTGATTGTGGTTTTGTTATGCAGTATGG	1375	1	1.0	ACAGTTTATGACTCTAGCGAAGTTAAAGCC	1	1.0	ATTGTGATTTTTATGGTTGGGTTTCAGG	{1310}
2.8905319690521503	658	809	151	658	1	1.0	GGTTGGATTGTACCTTTTGGTTTTATGCCA	779	1	1.0	TTAGTGTAGAAGATGCTTATGCTGAGGTTC	1	1.0	TCTGTAGGTTGTATATTGAAGAGAGTGA	{713}
2.9142885273623995	528	686	158	528	1	1.0	TTTGCATAGCTTGGGTGGTTTTCCTAAAGG	656	1	1.0	TGGGTTGGATTGTACCTTTTGGTTTTATGC	1	1.0	GTATGTTATGGGCTTGTTCCGTTCATAC	{558}
2.939443925003943	2794	2960	166	2794	1	1.0	GCTGTTGTTTGTGATGCTATAGAGAATGCT	2930	1	1.0	CAATGGCCTCTCGTATGTATTGTACTTTTG	1	1.0	CTCTTGTAAAGAGCATCCAGTGGTTGGT	{2829}
2.9570942636811997	1730	1902	172	1730	1	1.0	GTAGGCAACTGTTGCTTAATAGAGGTGATT	1872	1	1.0	TCCCCGTAGTTATTATCTAATTCAGAGTGG	1	1.0	GTGCTGATTTTGCTTGCAAGTTTGCAGT	{1802}
2.9570942636811997	28966	29082	116	28966	1	1.0	TGGAAATCGTTCAGGAATCCTCAAGAAAAC	29052	1	1.0	CCCAACCTAAATTCACTGTGTCTACTCAAC	3	1.0	TTCTTGGGCTGACCAATCTGAGCGAAAT TTCTTGGGTTGACCAATCTGAGCGAAGC TTCTTGGGTTGACCAATTTGAGCGAAGC	{28996} {28996} {28996}
2.9710950406914325	891	1068	177	891	1	1.0	AGACCAGTATGGTTGTGACTATTCTGGTAA	1038	1	1.0	TGATTCACGATTTGTTATGCGCCTGCAGAC	1	1.0	ATTAGCAGATTGTCTTCAAGCTTATGGT	{921}
2.9710950406914325	9510	9687	177	9510	1	1.0	GAGTCCACTTTTGGGTCTGTTTACTATCAT	9657	1	1.0	TATGCATTTGCTAGTGATAGTGTTCAGTGC	1	1.0	AGTGGCAGTTATGGATGAAGATATTGGT	{9563}
2.9818714113224147	1257	1438	181	1257	1	1.0	GTGTGATTGTGGTTTTGTTATGCAGTATGG	1408	1	1.0	TCATCTGGTGTTATTCCTGAAAATCCTGTG	1	1.0	ATTGTGATTTTTATGGTTGGGTTTCAGG	{1310}
2.992297268051916	2846	3031	185	2846	1	1.0	CAGTGGTTGGTTATCAAGTTCGTGCATTTT	3001	1	1.0	GAAGATACTATTGATGGTGTCGTTGAAGAC	1	1.0	CGTATGTATTGTACTTTTGCTATTGAGG	{2941}
2.9948515990016813	2665	2851	186	2665	1	1.0	GTTATGGAGATTCCGTCTTTGATGACAGTT	2821	1	1.0	GCTTTAAACTCTTGTAAAGAGCATCCAGTG	1	1.0	AGGTTATGTTTGATTTAGATTCTACTTT	{2696}
3.0121837571683643	1322	1515	193	1322	1	1.0	ATGGTTGGGTTTCAGGTAATATGATGGATG	1485	1	1.0	GTATGGTTATTCTGTCACACCATTTGGTTC	1	1.0	GTTTTTCTTGTCCATTGTGTTGTACAGT	{1352}
3.0121837571683643	7118	7311	193	7118	1	1.0	GGTTACTTCTGTTATGGAATCGCAGATTAG	7281	1	1.0	ACAGGTTGTGATTATGTTGTTTGGGTTGCT	1	1.0	TTTAGTTGATGTTTGGGATATGTATTTG	{7253}
3.0216827288338286	804	1001	197	804	1	1.0	GGTTCATGCTGAGCCTAAAGGTAAATATTC	971	1	1.0	GACAAAAGCAGTCTGTATGGCTTGCCAATT	1	1.0	ATTAGCAGATTGTCTTCAAGCTTATGGT	{921}
3.026328706359163	2794	2993	199	2794	1	1.0	GCTGTTGTTTGTGATGCTATAGAGAATGCT	2963	1	1.0	TTGAGGATGTTGAAGACGTTATCAGTAGTG	1	1.0	CTCTTGTAAAGAGCATCCAGTGGTTGGT	{2829}
3.04426719502264	2616	2823	207	2616	1	1.0	GCGTTTTCCATGTGCAGGTAGAAAAGTTAA	2793	1	1.0	TGCTGTTGTTTGTGATGCTATAGAGAATGC	1	1.0	ACAGTTAAGGTTATGTTTGATTTAGATT	{2689}
3.0464405378427526	2363	2571	208	2363	1	1.0	CTGGTTTTGTTTTACCATGTAATGCACAGG	2541	1	1.0	CATGGGTAAGTGTGGTGATAAATTTTTCCC	1	1.0	AATTTATTTTTTTGAAGGCGTTGCAGAG	{2400}
3.059179969342407	6910	7124	214	6910	1	1.0	CTGGTGATGTTGTTTTGGCATCTGATGATT	7094	1	1.0	ATCTGAGGAGTCACAAGGTAATGTGGTTAC	1	1.0	GATATAGTGTTTTGTCTGTTGATTCTGT	{7066}
3.0734297303170677	8863	9084	221	8863	1	1.0	GAGAGGGTGTGCAATTAGAAAAGGTTTTAG	9054	1	1.0	GTAGCTGCTGATTTAGGTGTTCTTATACAG	1	1.0	ATACTTTTGTGGGATGTGTACGTAAATG	{8893}
3.077387395870145	1322	1545	223	1322	1	1.0	ATGGTTGGGTTTCAGGTAATATGATGGATG	1515	1	1.0	TTGTATATATTGGTCGCCGCGTCCTGGATT	1	1.0	GTTTTTCTTGTCCATTGTGTTGTACAGT	{1352}
3.0812967960054203	7118	7343	225	7118	1	1.0	GGTTACTTCTGTTATGGAATCGCAGATTAG	7313	1	1.0	TGAATTGTCACGCCTAGTTAAATCACCAAC	1	1.0	TTTAGTTGATGTTTGGGATATGTATTTG	{7253}
3.0851590937877345	804	1031	227	804	1	1.0	GGTTCATGCTGAGCCTAAAGGTAAATATTC	1001	1	1.0	GTGACTTTGATATTGTAGTGGCTTGGCATG	1	1.0	ATTAGCAGATTGTCTTCAAGCTTATGGT	{921}
3.0946160284948063	892	1124	232	892	1	1.0	GACCAGTATGGTTGTGACTATTCTGGTAAA	1094	1	1.0	ATGTTGCACAACCTACAGAAGATGTAGTAG	1	1.0	TAGTTCGTGATTCACGATTTGTTATGCG	{1031}
3.103801953228442	658	895	237	658	1	1.0	GGTTGGATTGTACCTTTTGGTTTTATGCCA	865	1	1.0	CGTGGTATTAAACCCGTACTTTTTGTAGAC	1	1.0	TCTGTAGGTTGTATATTGAAGAGAGTGA	{713}
3.1074038657081178	2616	2855	239	2616	1	1.0	GCGTTTTCCATGTGCAGGTAGAAAAGTTAA	2825	1	1.0	TAAACTCTTGTAAAGAGCATCCAGTGGTTG	1	1.0	ACAGTTAAGGTTATGTTTGATTTAGATT	{2689}
3.1091897580044536	569	809	240	569	1	1.0	GCTTGTTCCGTTCATACAAGACTAAACGTT	779	1	1.0	TTAGTGTAGAAGATGCTTATGCTGAGGTTC	1	1.0	TAATTTTGGTGAAGATTTTTTGGGTTGG	{636}
3.1091897580044536	8749	8989	240	8749	1	1.0	GTATCTCTGTAACCCAGACTATGTTTGATG	8959	1	1.0	CTAAATCTATGATATCTGCAGTAGCTGCTG	1	1.0	TTTTAGATACTTTTGTGGGATGTGTACG	{8887}
3.1109657561098882	1873	2114	241	1873	1	1.0	CCCCGTAGTTATTATCTAATTCAGAGTGGT	2084	1	1.0	GGTTTAATACCATGTTAGATGCTAGTGCAC	1	1.0	TGATATGTGTTTAAAAATGTGTATTTTG	{1947}
3.123129642842771	1126	1374	248	1126	1	1.0	GGAGATGTAGTTATACGTGAACCTGTACAT	1344	1	1.0	GATGGATGGTTTTTCTTGTCCATTGTGTTG	1	1.0	ATTGTGATTTTTATGGTTGGGTTTCAGG	{1310}
3.1248302666619225	2123	2372	249	2123	1	1.0	GCTGGCTTCTTTACCAATTATTGAATGGTC	2342	1	1.0	ACGTTAGTACAGGGTTAATTCCTGGTTTTG	1	1.0	AAGTTATTATTAGAGTGTGTTACAGTTG	{2242}
3.1265219161711366	4697	4947	250	4697	1	1.0	GGATGTAAACGTTTGTCATTCTGTAGCTGT	4917	1	1.0	GCTGATGTTATTGTTAATCCTGCTAATGGG	1	1.0	GGTGATGAACAAATAGATGGTAAGTTTG	{4731}
3.1364885273623995	28966	29124	158	28966	1	1.0	TGGAAATCGTTCAGGAATCCTCAAGAAAAC	29094	1	1.0	CTATCCCACATTATTCCTGGTTCTCCGGGA	3	1.0	TTCTTGGGCTGACCAATCTGAGCGAAAT TTCTTGGGTTGACCAATCTGAGCGAAGC TTCTTGGGTTGACCAATTTGAGCGAAGC	{28996} {28996} {28996}
3.1793942636811994	2911	2999	88	2911	1	1.0	GATGAGGCTGGTGATGAAGCAATGGCCTCT	2969	2	1.0	ATGTTGAAGACGTTATCAGTAGCGAAGATG ATGTTGAAGACGTTATCAGTAGTGAAGCTG	1	1.0	CGTATGTATTGTACTTTTGCTATTGAGG	{2941}
3.2856163730311914	20926	21025	99	20926	2	1.0	AGGTAATGCCAGCGGTAATGATGCTCTAGC GGGTAATGTCATTGGTAATGATGCTCTAAC	20995	1	1.0	TTTTGAACCTCGCTCAGATTTAGAACGGGA	1	1.0	TCTTTACTCAGAGTCGTGTATTGTCAAG	{20967}
3.5642010878282044	2846	2999	153	2846	1	1.0	CAGTGGTTGGTTATCAAGTTCGTGCATTTT	2969	2	1.0	ATGTTGAAGACGTTATCAGTAGCGAAGATG ATGTTGAAGACGTTATCAGTAGTGAAGCTG	1	1.0	CGTATGTATTGTACTTTTGCTATTGAGG	{2941}
3.7881199489870325	1489	1736	247	1489	1	1.0	GGTTATTCTGTCACACCATTTGGTTCTTGT	1706	2	1.0	TTCTTGGCGTTAATAATTCTTGGTGTAGGC TTCTTGGTGTTAATAATTCTTGGTGCAGGC	1	1.0	TTGGTCGCCGCGTCCTGGATTGTGGATT	{1524}
3.960332422683972	28966	29186	220	28966	1	1.0	TGGAAATCGTTCAGGAATCCTCAAGAAAAC	29156	2	1.0	TTTCCAGATGGTCAAGGAGTACCCATTGCT TTTTCAGATGGTCAAGGAGTTCCCATTGCT	3	1.0	TTCTTGGGCTGACCAATCTGAGCGAAAT TTCTTGGGTTGACCAATCTGAGCGAAGC TTCTTGGGTTGACCAATTTGAGCGAAGC	{28996} {28996} {28996}
4.125785018119718	21439	21566	127	21439	2	1.0	CTGGAAACCTGGTTATTCTATGCCTGTTTT TTGGAAACCTGGCTATTCTATGCCTGTTTT	21536	2	1.0	CCAACAGGTTGTATGATGAATGTTGCTAAG CCTACAGGCTGTATGATGAATGTTGCTAAG	1	1.0	TTTGAATGTTCCATTAGAGAGAGTCTCT	{21478}
4.388389493487165	21439	21651	212	21439	2	1.0	CTGGAAACCTGGTTATTCTATGCCTGTTTT TTGGAAACCTGGCTATTCTATGCCTGTTTT	21621	2	1.0	TGCGTGTCTTACACTTAGGTGCAGGATCTG TGCGTGTTTTACATTTAGGTGCAGGGTCTG	1	1.0	TTTGAATGTTCCATTAGAGAGAGTCTCT	{21478}
4.410787395870146	20926	21149	223	20926	2	1.0	AGGTAATGCCAGCGGTAATGATGCTCTAGC GGGTAATGTCATTGGTAATGATGCTCTAAC	21119	2	1.0	GTTATAGGAGGTTTGCACTTGCTTATAGGT GTTATAGGAGGTTTGCATTTGCTTATAGGC	1	1.0	TCTTTACTCAGAGTCGTGTATTGTCAAG	{20967}
4.446131969052151	21439	21681	242	21439	2	1.0	CTGGAAACCTGGTTATTCTATGCCTGTTTT TTGGAAACCTGGCTATTCTATGCCTGTTTT	21651	2	1.0	ATAAAGAAGTAGCCCCTGGTTCTGCTGTTT ATAAAGAAGTAGCTCCAGGTTCTGCTGTTT	1	1.0	TTTGAATGTTCCATTAGAGAGAGTCTCT	{21478}
4.682121916171137	28966	29216	250	28966	1	1.0	TGGAAATCGTTCAGGAATCCTCAAGAAAAC	29186	3	1.0	TACGGGATACCCCCTTCTGAAGCAAAAGGA TTCGGAGTACCCCCTTCTGAAGCAAAAGGA TTCGGAGTACCCCTCTCTGAAGCAAAAGGA	3	1.0	TTCTTGGGCTGACCAATCTGAGCGAAAT TTCTTGGGTTGACCAATCTGAGCGAAGC TTCTTGGGTTGACCAATTTGAGCGAAGC	{28996} {28996} {28996}
