cost	target-start	target-end	target-length	left-primer-start	left-primer-num-primers	left-primer-frac-bound	left-primer-target-sequences	right-primer-start	right-primer-num-primers	right-primer-frac-bound	right-primer-target-sequences	num-guides	total-frac-bound-by-guides	guide-target-sequences	guide-target-sequence-positions
2.7111377053709504	13454	13566	112	13454	1	0.9909255898366606	GTTAACTTCACCGTTGATCCTCAAAAAGCT	13536	1	0.9909255898366606	TGCTTACTCCTAAAACTGGTACAGGTATAG	1	0.9872958257713249	ATCTCGATTTCGTCAATGCGGGAGGTGT	{13485}
2.7623098364064735	9257	9378	121	9257	1	0.9909255898366606	CTACATTGGCTTGGGTGAACAATCAGATAA	9348	1	0.9909255898366606	GATACCCTATAAGAGTTTCTCTGATAGTGG	1	0.985480943738657	TCTCGAGTCTTTGCTAATACAGGTAGTG	{9298}
2.8571480554261384	13454	13596	142	13454	1	0.9909255898366606	GTTAACTTCACCGTTGATCCTCAAAAAGCT	13566	1	0.9909255898366606	CTATATCTGTTAAACCAGAGAGTACAGCTG	1	0.9872958257713249	ATCTCGATTTCGTCAATGCGGGAGGTGT	{13485}
3.030908310503012	13454	13655	201	13454	1	0.9909255898366606	GTTAACTTCACCGTTGATCCTCAAAAAGCT	13625	1	0.9909255898366606	TGTCTCTATTGCCGTGCGCATATAGAACAT	1	0.9872958257713249	ATCTCGATTTCGTCAATGCGGGAGGTGT	{13485}
3.2015110903442126	4914	5004	90	4914	1	0.9909255898366606	TGGTGGTTACAATTCTTGGCATTTAGTCGA	4974	2	0.9909255898366606	AAATAAGCTCCTGCATTGGTCTGATCAAAC TAACAAGCTCCTTCATTGGTCAGATCAAAC	1	0.9872958257713249	GGGTGAATTATTGGTGCAAGACTTACGC	{4944}
3.324285705661207	2861	2965	104	2861	2	0.9909255898366606	GAGGTGCACCTGTAAAAAAAGTAGCCTTTG GTGGTGCACCTGTTAGAGAGCTGACCTTTG	2935	1	0.9909255898366606	GTCGAGTACAACATTCATGCTGTATTAGAC	1	0.985480943738657	GAGGTGATCAAGTACATGAGGTTGCTGC	{2891}
3.3521786676602408	10210	10318	108	10210	2	0.9909255898366606	CAAGGACACTTATGCAGCTCTTAGAAACTC CAAGGATACTTATGCTGCTCTCAGAAATTC	10288	1	0.9909255898366606	TAAGTACTTCTCTGGTGCTATGGAAACAGC	1	0.9872958257713249	TAATGATGCCTATTCACGATTTTTGGGG	{10246}
3.515932422683972	10210	10350	140	10210	2	0.9909255898366606	CAAGGACACTTATGCAGCTCTTAGAAACTC CAAGGATACTTATGCTGCTCTCAGAAATTC	10320	1	0.9909255898366606	CTTATCGTGAAGCTGCAGCATGTCATCTTG	1	0.9872958257713249	TAATGATGCCTATTCACGATTTTTGGGG	{10246}
3.5464857056612074	8412	8560	148	8412	2	0.9909255898366606	GCTGTATAATGTCACACGCGATAAGTTGGA GTTGTACAATGTCACACGTGATAAGTTGGA	8530	1	0.9909255898366606	CCCGCAGGTGTGGAGTCTGATGTTGAGACC	1	0.985480943738657	TTACTGCTCGTGATGGCGTAAGGCGAGG	{8453}
3.5676296428427707	13407	13561	154	13407	2	0.9909255898366606	CCGGTTCTAATACCGAGTTTGCTTCTAATT CTGGTTCTAACACCGAGTTTGCCTCTAATT	13531	1	0.9909255898366606	TAAGATGCTTACTCCTAAAACTGGTACAGG	1	0.9872958257713249	ATCTCGATTTCGTCAATGCGGGAGGTGT	{13485}
3.6180181283451796	4914	5084	170	4914	1	0.9909255898366606	TGGTGGTTACAATTCTTGGCATTTAGTCGA	5054	2	0.9909255898366606	TGCCATTTGAAACTGTTGAGGCTTGTCGCA TTCCATTTGAAACACTTTCAGCATGTCGTG	1	0.9872958257713249	GGGTGAATTATTGGTGCAAGACTTACGC	{4944}
3.643228507007025	8412	8591	179	8412	2	0.9909255898366606	GCTGTATAATGTCACACGCGATAAGTTGGA GTTGTACAATGTCACACGTGATAAGTTGGA	8561	1	0.9909255898366606	ATGAAATTGTTGACTCTGTGCAGTATGCTC	1	0.985480943738657	TTACTGCTCGTGATGGCGTAAGGCGAGG	{8453}
3.6640857374007747	10169	10356	187	10169	2	0.9909255898366606	TGTACGTTTCAGGAAGCTGCAAGTAATATC TGTAGTTTCCAGGACGCTGCCTCTAATATC	10326	1	0.9909255898366606	GTGAAGCTGCAGCATGTCATCTTGCTAAAG	1	0.9872958257713249	TAATGATGCCTATTCACGATTTTTGGGG	{10246}
3.6812850181197168	4742	4936	194	4742	2	0.9909255898366606	CCTTGGGATATGTATCGCATGGATTGGATT CTTTGGGATATGTGTCTCATGGTTTAGACT	4906	1	0.9909255898366606	CGCACTAATGGTGGTTACAATTCTTGGCAT	1	0.9872958257713249	AAGCAGGGAGTGTCGTGCGTAGAGTTAA	{4778}
3.6812850181197168	4932	5126	194	4932	1	0.9909255898366606	GCATTTAGTCGAGGGTGAACTATTGGTGCA	5096	2	0.9909255898366606	CACGCACGACACAGCAGTTAACAATCGAAG CACGTACGACACAGCAATTAACAATCGAAG	1	0.9872958257713249	CTTTCAGCATGTCGTGCGTATTTGGATT	{5068}
3.7279548428519353	8353	8568	215	8353	2	0.9909255898366606	GGCAACACTAGTGAAATTGCCATCAAGATG GGTGATTCTAGTGAAATCGCCACTAAAATG	8538	1	0.9909255898366606	TGTGGAGTCTGATGTTGAGACCAATGAAAT	1	0.985480943738657	TTACTGCTCGTGATGGCGTAAGGCGAGG	{8453}
3.7279548428519353	9257	9472	215	9257	1	0.9909255898366606	CTACATTGGCTTGGGTGAACAATCAGATAA	9442	2	0.9945553539019963	CATGATCCTACTGTTTTGCCTGGGGCTTTT TATGACCCTACTGTATTACCTGGTGCTCAT	1	0.985480943738657	TCTCGAGTCTTTGCTAATACAGGTAGTG	{9298}
3.7341000822449524	7624	7842	218	7624	1	0.9909255898366606	GCAGGTACATTGCATTATTTCTTTGCACAG	7812	2	0.9909255898366606	CAAAGATACGGCATGCTTGCTCTGCTATAA CAAGGACACCGCATGCCTTCTTTGTTATAA	1	0.985480943738657	GCGGGTTTGGTACGAATGTATAATTTGT	{7732}
3.74799679600542	10092	10317	225	10092	2	0.9909255898366606	GCTTTAGACACTTCTTCTGGGTTTTAGCTT GTTTTAGACATTTCTTCTGGGTTTTGGCCT	10287	1	0.9909255898366606	ATAAGTACTTCTCTGGTGCTATGGAAACAG	1	0.9872958257713249	TAATGATGCCTATTCACGATTTTTGGGG	{10246}
3.7556754107419015	26439	26668	229	26439	1	0.9909255898366606	TACTTGTTTGTATATCCCTAAACCCACAGC	26638	2	0.9909255898366606	GGATGTTCACTCTACTTACGGCACTCAAGC GGATGTTCCCTCTACCTCCGGCACTCAAGT	1	0.985480943738657	TACGCAGCTCAGCGAATCGCTTGGTTGC	{26584}
3.784672960526724	8353	8598	245	8353	2	0.9909255898366606	GGCAACACTAGTGAAATTGCCATCAAGATG GGTGATTCTAGTGAAATCGCCACTAAAATG	8568	1	0.9909255898366606	TGTTGACTCTGTGCAGTATGCTCATAAACA	1	0.985480943738657	TTACTGCTCGTGATGGCGTAAGGCGAGG	{8453}
3.784672960526724	9257	9502	245	9257	1	0.9909255898366606	CTACATTGGCTTGGGTGAACAATCAGATAA	9472	2	0.9909255898366606	CCGTACAGTGCAATGAAGCCCCATGTTAGG GCGTACAGTCAGATGAGGCCTCATGTTCGT	1	0.985480943738657	TCTCGAGTCTTTGCTAATACAGGTAGTG	{9298}
3.7898296428427707	13407	13655	248	13407	2	0.9909255898366606	CCGGTTCTAATACCGAGTTTGCTTCTAATT CTGGTTCTAACACCGAGTTTGCCTCTAATT	13625	1	0.9909255898366606	TGTCTCTATTGCCGTGCGCATATAGAACAT	1	0.9872958257713249	ATCTCGATTTCGTCAATGCGGGAGGTGT	{13485}
3.8460942636811994	2809	2897	88	2809	2	0.9909255898366606	TACCCTGCTTGCACTAATGGTCATGCTGTA TACCCTGCTTGTACAAATGGTTGTGCTGTA	2867	2	0.9909255898366606	CACCTGTAAAAAAAGTAGCCTTTGGCGGTG CACCTGTTAGAGAGCTGACCTTTGGTGACG	1	0.9872958257713249	CCGACTCTCTTTAGACTTAAGGGAGGTG	{2839}
3.8460942636811994	6050	6138	88	6050	2	0.9909255898366606	GACAGAAGTACAGTAGTGACTGTAATGTCG GCCAAAAATACAGTAGCGATTGTAATGTCG	6108	2	0.9909255898366606	AACAGAGGTTGATCCCGACCTATCTGCTTT GACAGAGGTTGATCCTAACCTATCTGGGTT	1	0.9818511796733213	TACGGTATTTTTTGGACGGTAATTTCAG	{6080}
3.8460942636811994	24098	24186	88	24098	2	0.9909255898366606	GTGGGTTGTGCTATGGGTATAGTTAATAGC GTTGGTTGTGTCCTAGGACTTGTTAATTCC	24156	2	0.9909255898366606	CAATTGGTCAGTCACTCTGTGCTGTACCTC CTCTTGGTCAATCTCTCTGTGCTCTTCCTG	1	0.9872958257713249	TCTTTGTTCGTAGAGGACTGCAAGTTGC	{24128}
3.8682110903442126	26578	26668	90	26578	2	0.9909255898366606	AAACAGGACGCAGCTCAGCGAATCGCTTGG AAACAGGATGCAGCACAGCGAATCGCCTGG	26638	2	0.9909255898366606	GGATGTTCACTCTACTTACGGCACTCAAGC GGATGTTCCCTCTACCTCCGGCACTCAAGT	1	0.985480943738657	TTGCTACATAAGGATGGAGGAGTCCCTG	{26608}
3.8889	3170	3262	92	3170	2	0.9909255898366606	CAACTATGATCTTTTCATTACACCCTGTGG CTACTATGATCTTCTCTCTTCACCCCGTCG	3232	2	0.9909255898366606	GATGGTGCCGAGGAAGAAGTCACCGTTGAT TCAGATTTAGAAGAAGGTGAATCAGAGTGC	1	0.985480943738657	TGACGAGGAGTGTTCTGAAGTAGAGGCT	{3204}
3.935440537842753	22418	22515	97	22418	2	0.9909255898366606	CGGGTGCTTATTTTAATCACACCCTTCTTA TGGGCCGCTTCTTCAATCATACTCTAGTTC	22485	2	0.9909255898366606	ATATTGTTTACTTCAGCCTCGCACTGAGTC TTATTGTATTCTAGAGCCTCGCTCTGGAAA	1	0.9872958257713249	GATGGATGTGGCACTTTACTTAGAGCTT	{22456}
4.044537705370951	4095	4207	112	4095	1	0.9909255898366606	TAATGCTGCTAACACACATCTTAAGCATGG	4177	3	0.9909255898366606	GAGTCAGATGAATACATTCTGGCTAGGGGT GAGTCAGATGAATATCTGACTCAGCGTGGA GAGTCAGATGAGTATATTCTGGCTAAAGGG	1	0.985480943738657	TAATGCGGCTTCAAAAGGGGCTGTCCAG	{4146}
4.050643925003943	8412	8525	113	8412	2	0.9909255898366606	GCTGTATAATGTCACACGCGATAAGTTGGA GTTGTACAATGTCACACGTGATAAGTTGGA	8495	2	0.9909255898366606	CAGTTTTGAAAGTCTTTATAGACGCTGCAC GTGTCTTAACAACATTCATTGACGCAGCAC	1	0.985480943738657	TTACTGCTCGTGATGGCGTAAGGCGAGG	{8453}
4.079543377117346	26646	26735	89	26646	2	0.9909255898366606	ACTCTACTTACGGCACTCAAGCCTACTCCC CCTCTACCTCCGGCACTCAAGTTTATTCGC	26705	2	0.9909255898366606	ACTAAGAAACTGCGCTACGTTAAGCGTAGA GGTAAAAACCTTCGATACGTTAAACGTAGG	3	0.985480943738657	GCAAAGCGAGGAAGAGGAGCCATTCTCC GCAAAGCGAGGAAGAGGAGTCATTCTCC GCAAAGCGAGGAAGAGGTGCCATTCTCC	{26676} {26676} {26676}
4.085023285568202	6017	6136	119	6017	2	0.9927404718693285	GGAAGTGCAAGGTGACAGATGTACTTTTCC GGAAGTGCAAGGTTACTGACATTTTATACC	6106	2	0.9909255898366606	AAGACAGAGGTTGATCCTAACCTATCTGGG AGAACAGAGGTTGATCCCGACCTATCTGCT	1	0.9836660617059891	GATTGTAATGTCGTACGGTATTTTTTGG	{6067}
4.085023285568202	26607	26726	119	26607	2	0.9909255898366606	GCTGCTCCATAGAGATGGAGGAATACCCGA GTTGCTACATAAGGATGGAGGAATCCCTGA	26696	2	0.9909255898366606	CATTCACCAGGTAAAAACCTTCGATACGTT CATTCTCCAACTAAGAAACTGCGCTACGTT	1	0.985480943738657	TCAAGTTTATTCGCGCAAAGCGAGGAAG	{26662}
4.120964373321449	3131	3257	126	3131	2	0.9909255898366606	GCTACTGCTTTAATGCAGATGGTGATGAAG GCTATTGCTTTAACGCTGAGGGTGATGCAT	3227	2	0.9909255898366606	AAGCTGATGGTGCCGAGGAAGAAGTCACCG AGGCTTCAGATTTAGAAGAAGGTGAATCAG	1	0.985480943738657	CACCCCGTCGAGTGTGACGAGGGGTGTT	{3190}
4.120964373321449	4742	4868	126	4742	2	0.9909255898366606	CCTTGGGATATGTATCGCATGGATTGGATT CTTTGGGATATGTGTCTCATGGTTTAGACT	4838	2	0.9909255898366606	AGCAACAAGCCATTTTGATGTCTGAAGATG AGCAAGAAGCTATTTTGATGTCTGAAGACG	1	0.9872958257713249	AAGCAGGGAGTGTCGTGCGTAGAGTTAA	{4778}
4.125785018119718	6050	6177	127	6050	2	0.9909255898366606	GACAGAAGTACAGTAGTGACTGTAATGTCG GCCAAAAATACAGTAGCGATTGTAATGTCG	6147	2	0.9909255898366606	GGATGGTAAATACTTCACAAGTCAACCCTC GGATGGTAAATACTTTACAAGTGAACCACC	1	0.9818511796733213	TACGGTATTTTTTGGACGGTAATTTCAG	{6080}
4.148857335320482	24031	24163	132	24031	2	0.9909255898366606	CTCCCGTTCTACGCGATCAATGCTTAAACG TTCTCGTGAAACTAGAGCTTCTCTTGTTTC	24133	2	0.9909255898366606	CACTGTTGAAGAATGCAATCTTTCTTTGGG GTTCGTAGAGGACTGCAAGTTGCCTCTTGG	1	0.9872958257713249	TGTGTCCTAGGACTTGTTAATTCCTCTT	{24104}
4.161943513028185	2861	2996	135	2861	2	0.9909255898366606	GAGGTGCACCTGTAAAAAAAGTAGCCTTTG GTGGTGCACCTGTTAGAGAGCTGACCTTTG	2966	2	0.9909255898366606	CACTACTTGCTTCTTCTAGTCTTAGAACCT CACTTTTGGCTTCTTCTAGTCTTAGAACCT	1	0.985480943738657	GAGGTGATCAAGTACATGAGGTTGCTGC	{2891}
4.161943513028185	4991	5126	135	4991	2	0.9909255898366606	GGTCTGATCAAACCATATGCTACAAGGATA GGTCTGATCAAACCGTGTGTTATAGTGGTC	5096	2	0.9909255898366606	CACGCACGACACAGCAGTTAACAATCGAAG CACGTACGACACAGCAATTAACAATCGAAG	1	0.9872958257713249	CTTTCAGCATGTCGTGCGTATTTGGATT	{5068}
4.170379969342408	2697	2834	137	2697	2	0.9909255898366606	GGGTCAACTTGAGCAAACTAATATGCATAG TGGTCAATTGGAACAGACTAATATGCATGG	2804	2	0.9909255898366606	CCTTCTACCCTGCTTGCACTAATGGTCATG TCTTCTACCCTGCTTGTACAAATGGTTGTG	1	0.9872958257713249	GTGCGTAGTAGGGAAGAAGACGGATTCG	{2776}
4.194433761645287	4683	4826	143	4683	2	0.9909255898366606	AGATGACATCAAATCTGTAGTTGCTGCAGC GGACACTTTAGATGATATCTTACAACAGGC	4796	2	0.9909255898366606	GTAAGGTCAAAGTACCTTATGTATGCCTTC GTAGAGTTAACGTGCCCTACGTGTGTCTCC	1	0.9818511796733213	AGACTTAATTCAAGCAGGGAGTGTCGTG	{4767}
4.202066666009798	2323	2468	145	2323	2	0.9909255898366606	GCAGGATTGTTCAGAATCTTTCTTCGCAAT GCTCAGTTGTTTAAGGTTTTCCTTAGACAG	2438	2	0.9909255898366606	AGGGTATGCAACTTTTGCATACAAAGGTCT AGGGTATGCAGCTTTTGCACACTAAAATCT	1	0.9872958257713249	GTTTGTGGTGGTCAATGGCAAAGTTTCT	{2376}
4.213185705661208	22367	22515	148	22367	2	0.9909255898366606	CTGCACTTATGTTGGGTAGTTCTTTTGGTA CTGCTTTTATGCTGGGTTCTTCAGTTGGTA	22485	2	0.9909255898366606	ATATTGTTTACTTCAGCCTCGCACTGAGTC TTATTGTATTCTAGAGCCTCGCTCTGGAAA	1	0.9872958257713249	GATGGATGTGGCACTTTACTTAGAGCTT	{22456}
4.216807968360734	26607	26756	149	26607	2	0.9909255898366606	GCTGCTCCATAGAGATGGAGGAATACCCGA GTTGCTACATAAGGATGGAGGAATCCCTGA	26726	2	0.9909255898366606	AAACGTAGGTTTTCTTCTTTACGCCCTGAA AAGCGTAGATTTTCTCTTCTGCGCCCTGAA	1	0.985480943738657	TCAAGTTTATTCGCGCAAAGCGAGGAAG	{26662}
4.220389758004454	7672	7822	150	7672	2	0.9909255898366606	TGGCGGTCATACAATTATGCTGTGTCTAGT TGGCGTTCATACAATTATGTTGTGTCTGGT	7792	2	0.9909255898366606	CAACACGTTATTAACGGTTGTAAGGACACG CAGCATGTAATCAATGGTTGCAAAGATACG	1	0.985480943738657	GCGGGTTTGGTACGAATGTATAATTTGT	{7732}
4.237721916171137	4095	4250	155	4095	1	0.9909255898366606	TAATGCTGCTAACACACATCTTAAGCATGG	4220	3	0.9909255898366606	GAGATTCAGTTCTCTTGCAAGGCCATTCTC GCGAATCTGCTCTCTTGCAAGGTCATTCTC GTGATGCTGTCTTGCTTAAGGGACATGGTT	1	0.985480943738657	TAATGCGGCTTCAAAAGGGGCTGTCCAG	{4146}
4.24440063353398	22698	22855	157	22698	1	0.9909255898366606	TGGCATTACACAAACTGCTCAAGGTGTTCA	22825	3	0.9909255898366606	CCGCGCTCCGTCATACAACCGTCCAATCAG CCTCACAGTATTCGTTCTATCCAAAGTGAT CCTCGTTCTATTCGCTCTTACCATGCAGAC	1	0.9872958257713249	CCTCTTCTCATCTCGGTATGTTGATTTG	{22728}
4.263640417140111	22149	22312	163	22149	2	0.9909255898366606	CAGGGTCAAATGTATTTATATTCAGCAGCC CATGGTGATATGTATGTTTACTCTGCAGGA	22282	2	0.9909255898366606	GTCGTCCGTATAGGAGCAGCTGCCAATTCC GTTGTCCGAATTGGTGCTTCATCTAATAAG	1	0.9872958257713249	AGTTGTTTGTAGCTAACTATTCTCAGGA	{22229}
4.263640417140111	22418	22581	163	22418	2	0.9909255898366606	CGGGTGCTTATTTTAATCACACCCTTCTTA TGGGCCGCTTCTTCAATCATACTCTAGTTC	22551	2	0.9909255898366606	CACTTATCACACTCCTGCAACAGATTGTTC TTTAGCCGATTCACCCAGTGATTGTTCTTC	1	0.9872958257713249	GATGGATGTGGCACTTTACTTAGAGCTT	{22456}
4.269805354025412	6050	6215	165	6050	2	0.9909255898366606	GACAGAAGTACAGTAGTGACTGTAATGTCG GCCAAAAATACAGTAGCGATTGTAATGTCG	6185	2	0.9909255898366606	ATTCACCAGCTACAATTCTAACTGGTAGTG ATTCACCAGCTACAATTTTAGCTGGTAGTG	1	0.9818511796733213	TACGGTATTTTTTGGACGGTAATTTCAG	{6080}
4.269805354025412	23879	24044	165	23879	2	0.9909255898366606	ATTGGCTTTCACTCTGATGACGGCAATTAC GTTGGCTATTATTCTGATGATGGCAACTAC	24014	2	0.9909255898366606	ACAATGGCTGCTCAGTTTTCTCGTGAAACT TCTACCATGTCTCAATACTCCCGTTCTACG	1	0.985480943738657	GTTTGCGTGCTTGTGTTAGTGTTCCTGT	{23913}
4.278836002980723	7624	7792	168	7624	1	0.9909255898366606	GCAGGTACATTGCATTATTTCTTTGCACAG	7762	3	0.9927404718693285	GCATGCCTTTGGCTTTTACGCAAGTTTTAT GCATGCCTTTGGCTTTTACGTAAGTTCTAT GCATGCTTATGGTTTTTGCGTCGTTTTTAC	1	0.985480943738657	GCGGGTTTGGTACGAATGTATAATTTGT	{7732}
4.28471812834518	10210	10380	170	10210	2	0.9909255898366606	CAAGGACACTTATGCAGCTCTTAGAAACTC CAAGGATACTTATGCTGCTCTCAGAAATTC	10350	2	0.9909255898366606	CTAAAGCCTTACAAACATACAGCGAGACTG CTAGAGCCTTACAAACATACAGTGAAACTG	1	0.9872958257713249	TAATGATGCCTATTCACGATTTTTGGGG	{10246}
4.2904942636812	8353	8525	172	8353	2	0.9909255898366606	GGCAACACTAGTGAAATTGCCATCAAGATG GGTGATTCTAGTGAAATCGCCACTAAAATG	8495	2	0.9909255898366606	CAGTTTTGAAAGTCTTTATAGACGCTGCAC GTGTCTTAACAACATTCATTGACGCAGCAC	1	0.985480943738657	TTACTGCTCGTGATGGCGTAAGGCGAGG	{8453}
4.293343765448655	22311	22484	173	22311	2	0.9909255898366606	CACTGGCACTGTTATTATTAGCCCATCTAC GACTGGTAATAATGTTATTTCACCCAGCAC	22454	2	0.9909255898366606	CCGATGGATGTGGCACTTTACTTAGAGCTT CTAGCAAGTGTGGAACTGTCTTCCAAGTTG	1	0.9872958257713249	CTGCTTTTATGCTGGGTTCTTCAGTTGG	{22367}
4.296168161147406	6017	6191	174	6017	2	0.9927404718693285	GGAAGTGCAAGGTGACAGATGTACTTTTCC GGAAGTGCAAGGTTACTGACATTTTATACC	6161	2	0.9909255898366606	TCACAAGTCAACCCTCCATAACTTATTCAC TTACAAGTGAACCACCCGTAACATATTCAC	1	0.9836660617059891	GATTGTAATGTCGTACGGTATTTTTTGG	{6067}
4.29896788931984	2323	2498	175	2323	2	0.9909255898366606	GCAGGATTGTTCAGAATCTTTCTTCGCAAT GCTCAGTTGTTTAAGGTTTTCCTTAGACAG	2468	2	0.9909255898366606	CATGGGCTGGTTCTAAAATTAATGCAGTCA CCTGGGCTGGTTCTAATATCAGTGCTGTTA	1	0.9872958257713249	GTTTGTGGTGGTCAATGGCAAAGTTTCT	{2376}
4.312611090344213	7672	7852	180	7672	2	0.9909255898366606	TGGCGGTCATACAATTATGCTGTGTCTAGT TGGCGTTCATACAATTATGTTGTGTCTGGT	7822	2	0.9945553539019963	GCATGCCTTCTTTGTTATAAGAGGAATCGT GCATGCTTGCTCTGCTATAAGAGGAACCGA	1	0.985480943738657	GCGGGTTTGGTACGAATGTATAATTTGT	{7732}
4.315271411322415	3076	3257	181	3076	2	0.9909255898366606	CTACGTGGTAAGCAAATTCCCGATTTTGAT CTGCGTGGAATGCCGATTCCAGATTTTGAT	3227	2	0.9909255898366606	AAGCTGATGGTGCCGAGGAAGAAGTCACCG AGGCTTCAGATTTAGAAGAAGGTGAATCAG	1	0.985480943738657	CACCCCGTCGAGTGTGACGAGGGGTGTT	{3190}
4.317909836406473	4531	4713	182	4531	2	0.9909255898366606	GGCGCAATACGTAAAGCTAAAGATTATGGT GGCGGCGTACGTAAGGCTAAAGATTATGGC	4683	2	0.9909255898366606	AGATGACATCAAATCTGTAGTTGCTGCAGC GGACACTTTAGATGATATCTTACAACAGGC	1	0.9872958257713249	AAGTTTCTTATAGTTGACGGTGTGCAAT	{4636}
4.320526723086379	2195	2378	183	2195	2	0.9909255898366606	GCCTCTTGCAAGATAAGACTGGCGACTTTA GTCTACTTGATGAGAAAGTAGAATCGCTTC	2348	2	0.9909255898366606	GCAATGCCTATGTGTACACTTCACAAGGGT GCGGAGCATATGTGTACACTTCACAGGGCT	1	0.9872958257713249	TGTTAGATTTGGCAGGATTGTTCAGAAT	{2312}
4.325697268051917	4095	4280	185	4095	1	0.9909255898366606	TAATGCTGCTAACACACATCTTAAGCATGG	4250	3	0.9927404718693285	TAGCTAAGAATATCCTGCATGTCGTAGGCC TAGCTAAGCATATCCTGCATGTTGTAGGAC TTGCTAAAAACATCTTGCATGTTGTAGGCC	1	0.985480943738657	TAATGCGGCTTCAAAAGGGGCTGTCCAG	{4146}
4.325697268051917	4683	4868	185	4683	2	0.9909255898366606	AGATGACATCAAATCTGTAGTTGCTGCAGC GGACACTTTAGATGATATCTTACAACAGGC	4838	2	0.9909255898366606	AGCAACAAGCCATTTTGATGTCTGAAGATG AGCAAGAAGCTATTTTGATGTCTGAAGACG	1	0.9818511796733213	AGACTTAATTCAAGCAGGGAGTGTCGTG	{4767}
4.330785737400776	22698	22885	187	22698	1	0.9909255898366606	TGGCATTACACAAACTGCTCAAGGTGTTCA	22855	3	0.9909255898366606	AGAAAAGCTTGGGCTGCCTTCTACGTATAT AGAAATGCATGGGCTGCGTTTTATGTGTAC CGAGATGCTTGGGCTGCGTTTTACATATAT	1	0.9872958257713249	CCTCTTCTCATCTCGGTATGTTGATTTG	{22728}
4.335794696155047	29180	29369	189	29180	3	0.9927404718693285	CACGTGCTGTTTCTTTTGCAGATAACAATG CCCGTGCCGTCTCTTTTGCAGATAACAATG CTCGTGCTGTTTCCTTTGCCGATAACAATG	29339	1	0.9909255898366606	CTGGGCAGGGTGTACCTCTTAATGCCAATT	1	0.985480943738657	GGTAGAGGACGTAATCCAAAACCACGAG	{29239}
4.345583757168365	22418	22611	193	22418	2	0.9909255898366606	CGGGTGCTTATTTTAATCACACCCTTCTTA TGGGCCGCTTCTTCAATCATACTCTAGTTC	22581	2	0.9909255898366606	CACTTCTGATGAAATACGCAGAAATGGGTT TGATGGCAATTACAATCGTAATGCCAGTCT	1	0.9872958257713249	GATGGATGTGGCACTTTACTTAGAGCTT	{22456}
4.350368425664695	2697	2892	195	2697	2	0.9909255898366606	GGGTCAACTTGAGCAAACTAATATGCATAG TGGTCAATTGGAACAGACTAATATGCATGG	2862	2	0.9909255898366606	AGGTGCACCTGTAAAAAAAGTAGCCTTTGG TGGTGCACCTGTTAGAGAGCTGACCTTTGG	1	0.9872958257713249	GTGCGTAGTAGGGAAGAAGACGGATTCG	{2776}
4.364308310503012	2861	3062	201	2861	2	0.9909255898366606	GAGGTGCACCTGTAAAAAAAGTAGCCTTTG GTGGTGCACCTGTTAGAGAGCTGACCTTTG	3032	2	0.9909255898366606	CTGACGTAGTAAAGGAACAAGTCTCAGACT TCCATGTGGTAAAGGAGCAGGTTGTAGACT	1	0.985480943738657	GAGGTGATCAAGTACATGAGGTTGCTGC	{2891}
4.364308310503012	5935	6136	201	5935	2	0.9909255898366606	GTTGGCCATTATGTCCATGCCCGTTTGAAG GTTGGCCATTATGTTCATGCTCGCCTGAAG	6106	2	0.9909255898366606	AAGACAGAGGTTGATCCTAACCTATCTGGG AGAACAGAGGTTGATCCCGACCTATCTGCT	1	0.9836660617059891	GATTGTAATGTCGTACGGTATTTTTTGG	{6067}
4.364308310503012	6050	6251	201	6050	2	0.9909255898366606	GACAGAAGTACAGTAGTGACTGTAATGTCG GCCAAAAATACAGTAGCGATTGTAATGTCG	6221	2	0.9909255898366606	CTAATAGCTGCCTTGTATCGTCTGATGGAC CTAATAGTTGCCTAGTATCTTCAGATGGAG	1	0.9818511796733213	TACGGTATTTTTTGGACGGTAATTTCAG	{6080}
4.366573809953941	10210	10412	202	10210	2	0.9909255898366606	CAAGGACACTTATGCAGCTCTTAGAAACTC CAAGGATACTTATGCTGCTCTCAGAAATTC	10382	2	0.9909255898366606	AGTGACTTGCTTTACCAGCCACCTAATTGT AGTGATCTTCTTTACCAACCACCCAACTGT	1	0.9872958257713249	TAATGATGCCTATTCACGATTTTTGGGG	{10246}
4.371057335320482	22311	22515	204	22311	2	0.9909255898366606	CACTGGCACTGTTATTATTAGCCCATCTAC GACTGGTAATAATGTTATTTCACCCAGCAC	22485	2	0.9909255898366606	ATATTGTTTACTTCAGCCTCGCACTGAGTC TTATTGTATTCTAGAGCCTCGCTCTGGAAA	1	0.9872958257713249	CTGCTTTTATGCTGGGTTCTTCAGTTGG	{22367}
4.3776671950226405	13407	13614	207	13407	2	0.9909255898366606	CCGGTTCTAATACCGAGTTTGCTTCTAATT CTGGTTCTAACACCGAGTTTGCCTCTAATT	13584	2	0.9945553539019963	AGAGTAATGCTGATCAAGAAACTTACGGTG AGAGTACAGCTGATCAAGAGACTTATGGTG	1	0.9872958257713249	ATCTCGATTTCGTCAATGCGGGAGGTGT	{13485}
4.3862735330780325	26607	26818	211	26607	2	0.9909255898366606	GCTGCTCCATAGAGATGGAGGAATACCCGA GTTGCTACATAAGGATGGAGGAATCCCTGA	26788	2	0.9909255898366606	CAACACACTATGTCAGGGTTACATTTTCAG CCACACATTACATCAGGGTTACATTTTCTG	1	0.985480943738657	TCAAGTTTATTCGCGCAAAGCGAGGAAG	{26662}
4.388389493487165	22071	22283	212	22071	2	0.9909255898366606	GGTATTATATACCCTCAAGGCCGTACATAT GGTGTTATTTATCCTACAGGCCGTACTTAT	22253	2	0.9909255898366606	ACTATGGCAATCCATTTGGCGATGGAATTG AGGACGTCAAACAGTTTGCTAATGGGTTTG	1	0.985480943738657	TCCCTATCAGGGAGACCATGGTGATAGG	{22133}
4.394654842851936	4095	4310	215	4095	1	0.9909255898366606	TAATGCTGCTAACACACATCTTAAGCATGG	4280	3	0.9927404718693285	CAGATGCCCGCGCTAAACAGGATGTTTCTC CAGATGCGCGTGCTAAACAGGATGTTTCTT CTGATGCTCGTGCAAAGCAAGATGTTTCTC	1	0.985480943738657	TAATGCGGCTTCAAAAGGGGCTGTCCAG	{4146}
4.394654842851936	4991	5206	215	4991	2	0.9909255898366606	GGTCTGATCAAACCATATGCTACAAGGATA GGTCTGATCAAACCGTGTGTTATAGTGGTC	5176	2	0.9909255898366606	AAGAACACTTATAGATCACAGCTTGGATGC AAGAACTCCTATAGGTCACAGTTGGGATGT	1	0.9872958257713249	CTTTCAGCATGTCGTGCGTATTTGGATT	{5068}
4.394654842851936	29082	29297	215	29082	2	0.9927404718693285	GCTGCGAGCATAAGCTCATTAGTAAGAGTA GCTTCGAGCTTAGGCTCTTTAGTAAGAGTA	29267	2	0.9909255898366606	CTGCACCAAATAACACTGTCTCTTGGTACA CTGCACCAAATACAACTGTCTCATGGTACA	1	0.985480943738657	GGTAGAGGACGTAATCCAAAACCACGAG	{29239}
4.396716373031192	2323	2539	216	2323	2	0.9909255898366606	GCAGGATTGTTCAGAATCTTTCTTCGCAAT GCTCAGTTGTTTAAGGTTTTCCTTAGACAG	2509	2	0.9909255898366606	AGAGAAGCACTTGTCTTTTCCACAGGAAGT AGGGAGTCTCTAATATTCCCATCGGGAACC	1	0.9872958257713249	GTTTGTGGTGGTCAATGGCAAAGTTTCT	{2376}
4.39876473040372	10169	10386	217	10169	2	0.9909255898366606	TGTACGTTTCAGGAAGCTGCAAGTAATATC TGTAGTTTCCAGGACGCTGCCTCTAATATC	10356	2	0.9909255898366606	CCTTACAAACATACAGCGAGACTGGTAGTG CTCTACAGACTTATAGTGAAACTGGTAGTG	1	0.9872958257713249	TAATGATGCCTATTCACGATTTTTGGGG	{10246}
4.4008000822449524	4531	4749	218	4531	2	0.9909255898366606	GGCGCAATACGTAAAGCTAAAGATTATGGT GGCGGCGTACGTAAGGCTAAAGATTATGGC	4719	2	0.9909255898366606	GTCTATTGGTATTGTATCTATGCCCTTGGG GTCTGTTGGTATTATATCTATGCCTTTGGG	1	0.9872958257713249	AAGTTTCTTATAGTTGACGGTGTGCAAT	{4636}
4.4008000822449524	22367	22585	218	22367	2	0.9909255898366606	CTGCACTTATGTTGGGTAGTTCTTTTGGTA CTGCTTTTATGCTGGGTTCTTCAGTTGGTA	22555	2	0.9909255898366606	TATCACACTCCTGCAACAGATTGTTCTGAT TGGGACACACCCACCTTAGATTGTATTAAT	1	0.9872958257713249	GATGGATGTGGCACTTTACTTAGAGCTT	{22456}
4.404832422683972	29180	29400	220	29180	3	0.9927404718693285	CACGTGCTGTTTCTTTTGCAGATAACAATG CCCGTGCCGTCTCTTTTGCAGATAACAATG CTCGTGCTGTTTCCTTTGCCGATAACAATG	29370	1	0.9909255898366606	CACCCCTGCGCAAAATGCTGGGTATTGGCG	1	0.985480943738657	GGTAGAGGACGTAATCCAAAACCACGAG	{29239}
4.414696796005421	2697	2922	225	2697	2	0.9909255898366606	GGGTCAACTTGAGCAAACTAATATGCATAG TGGTCAATTGGAACAGACTAATATGCATGG	2892	2	0.9909255898366606	CGGTGATCAAGTACATGAGGTTGCTGCTGT TGACGATGAAGTACATGAGGTAGCAGCTAT	1	0.9872958257713249	GTGCGTAGTAGGGAAGAAGACGGATTCG	{2776}
4.416633761645286	4683	4909	226	4683	2	0.9909255898366606	AGATGACATCAAATCTGTAGTTGCTGCAGC GGACACTTTAGATGATATCTTACAACAGGC	4879	2	0.9909255898366606	CCTTCAGAAGATTTTATAAAGCACGTCCGC CCTTCAGCCGATTTTATTAAGCATGTTCGC	1	0.9818511796733213	AGACTTAATTCAAGCAGGGAGTGTCGTG	{4767}
4.426146828807647	2861	3092	231	2861	2	0.9909255898366606	GAGGTGCACCTGTAAAAAAAGTAGCCTTTG GTGGTGCACCTGTTAGAGAGCTGACCTTTG	3062	2	0.9909255898366606	TGCTTGCTAAATTGCTACGTGGTAAGCAAA TGCTTGTTAAATTACTGCGTGGAATGCCGA	1	0.985480943738657	GAGGTGATCAAGTACATGAGGTTGCTGC	{2891}
4.426146828807647	6050	6281	231	6050	2	0.9909255898366606	GACAGAAGTACAGTAGTGACTGTAATGTCG GCCAAAAATACAGTAGCGATTGTAATGTCG	6251	2	0.9909255898366606	AACCTGGCGGTGATGCTATTAGTTTGAGTT AGCCAGGCGGTGATGCTATTAGTGCAGCGT	1	0.9818511796733213	TACGGTATTTTTTGGACGGTAATTTCAG	{6080}
4.428016028494806	10210	10442	232	10210	2	0.9909255898366606	CAAGGACACTTATGCAGCTCTTAGAAACTC CAAGGATACTTATGCTGCTCTCAGAAATTC	10412	2	0.9909255898366606	AGCATAACCTCTGGCGTGTTGCAAAGCGGT AGCATTACTTCTGGTGTGTTACAGAGTGGT	1	0.9872958257713249	TAATGATGCCTATTCACGATTTTTGGGG	{10246}
4.4298743921808805	2721	2954	233	2721	3	0.9927404718693285	GCATAGTCCAGACCTTATTGTAGGTGATTA GCATAGTCCTGATGTTATAGTAGGTGACTA GCATGGCCCCGATGTTATAGTAGGAGACTA	2924	1	0.9927404718693285	GAAGTGTTACTGTCGAGTACAACATTCATG	1	0.9872958257713249	GTGCGTAGTAGGGAAGAAGACGGATTCG	{2776}
4.431722044777588	23879	24113	234	23879	2	0.9909255898366606	ATTGGCTTTCACTCTGATGACGGCAATTAC GTTGGCTATTATTCTGATGATGGCAACTAC	24083	2	0.9909255898366606	CCCATACAAACACCTGTGGGTTGTGCTATG CCCCTTCAGACACCTGTTGGTTGTGTCCTA	1	0.985480943738657	GTTTGCGTGCTTGTGTTAGTGTTCCTGT	{23913}
4.433559109049144	22149	22384	235	22149	2	0.9909255898366606	CAGGGTCAAATGTATTTATATTCAGCAGCC CATGGTGATATGTATGTTTACTCTGCAGGA	22354	2	0.9909255898366606	AAAAAGATCTACCCTGCACTTATGTTGGGT CGAAAAATTTACCCTGCTTTTATGCTGGGT	1	0.9872958257713249	AGTTGTTTGTAGCTAACTATTCTCAGGA	{22229}
4.433559109049144	22311	22546	235	22311	2	0.9909255898366606	CACTGGCACTGTTATTATTAGCCCATCTAC GACTGGTAATAATGTTATTTCACCCAGCAC	22516	2	0.9909255898366606	CATTGTCCTGCTGGCAATTCCTATACTTCT CGTTGTCCTAATGACAATGCATACACTTCA	1	0.9872958257713249	CTGCTTTTATGCTGGGTTCTTCAGTTGG	{22367}
4.446131969052151	5935	6177	242	5935	2	0.9909255898366606	GTTGGCCATTATGTCCATGCCCGTTTGAAG GTTGGCCATTATGTTCATGCTCGCCTGAAG	6147	2	0.9909255898366606	GGATGGTAAATACTTCACAAGTCAACCCTC GGATGGTAAATACTTTACAAGTGAACCACC	1	0.9836660617059891	GATTGTAATGTCGTACGGTATTTTTTGG	{6067}
4.4548199489870335	2323	2570	247	2323	2	0.9909255898366606	GCAGGATTGTTCAGAATCTTTCTTCGCAAT GCTCAGTTGTTTAAGGTTTTCCTTAGACAG	2540	2	0.9909255898366606	ATTACTGTGTCACCACTAAGGCTAAGTCCG ATTATTGTGTCACCACCAAGGCAAAGTCTG	1	0.9872958257713249	GTTTGTGGTGGTCAATGGCAAAGTTTCT	{2376}
4.4548199489870335	10169	10416	247	10169	2	0.9909255898366606	TGTACGTTTCAGGAAGCTGCAAGTAATATC TGTAGTTTCCAGGACGCTGCCTCTAATATC	10386	2	0.9909255898366606	ACTTGCTTTACCAGCCACCTAATTGTAGCA ATCTTCTTTACCAACCACCCAACTGTAGCA	1	0.9872958257713249	TAATGATGCCTATTCACGATTTTTGGGG	{10246}
4.4548199489870335	22071	22318	247	22071	2	0.9909255898366606	GGTATTATATACCCTCAAGGCCGTACATAT GGTGTTATTTATCCTACAGGCCGTACTTAT	22288	2	0.9909255898366606	CGTATAGGAGCAGCTGCCAATTCCACTGGC CGTATAGGTCAAAATGCTAATAAGACTGGC	1	0.985480943738657	TCCCTATCAGGGAGACCATGGTGATAGG	{22133}
4.4548199489870335	29082	29329	247	29082	2	0.9927404718693285	GCTGCGAGCATAAGCTCATTAGTAAGAGTA GCTTCGAGCTTAGGCTCTTTAGTAAGAGTA	29299	2	0.9909255898366606	GGGCTTACCCAACACGGGAAAGTCCCTCTT GGTCTTACCCAACACGGGAAAGTTCCTTTA	1	0.985480943738657	GGTAGAGGACGTAATCCAAAACCACGAG	{29239}
4.456529642842772	22367	22615	248	22367	2	0.9909255898366606	CTGCACTTATGTTGGGTAGTTCTTTTGGTA CTGCTTTTATGCTGGGTTCTTCAGTTGGTA	22585	2	0.9909255898366606	GGCAATTACAATCGTAATGCCAGTCTGAAC TCTGATGAAATACGCAGAAATGGGTTACGA	1	0.9872958257713249	GATGGATGTGGCACTTTACTTAGAGCTT	{22456}
4.5126942636812	26646	26818	172	26646	2	0.9909255898366606	ACTCTACTTACGGCACTCAAGCCTACTCCC CCTCTACCTCCGGCACTCAAGTTTATTCGC	26788	2	0.9909255898366606	CAACACACTATGTCAGGGTTACATTTTCAG CCACACATTACATCAGGGTTACATTTTCTG	3	0.985480943738657	GCAAAGCGAGGAAGAGGAGCCATTCTCC GCAAAGCGAGGAAGAGGAGTCATTCTCC GCAAAGCGAGGAAGAGGTGCCATTCTCC	{26676} {26676} {26676}
4.625022592664184	26646	26865	219	26646	2	0.9909255898366606	ACTCTACTTACGGCACTCAAGCCTACTCCC CCTCTACCTCCGGCACTCAAGTTTATTCGC	26835	2	0.9909255898366606	CTACGTTCGGGTCATCATTTACACTCAGTT CTACGTTCTGGTCATCACTTACACTCAGTT	3	0.985480943738657	GCAAAGCGAGGAAGAGGAGCCATTCTCC GCAAAGCGAGGAAGAGGAGTCATTCTCC GCAAAGCGAGGAAGAGGTGCCATTCTCC	{26676} {26676} {26676}
4.698664845367944	23879	23989	110	23879	2	0.9909255898366606	ATTGGCTTTCACTCTGATGACGGCAATTAC GTTGGCTATTATTCTGATGATGGCAACTAC	23959	3	0.9909255898366606	AGAAACTAAAACCCACGCTACTCTATTTGG CAACACTAACCAATACGCTACCTTGTTTGG GCCATCTGACAAACATGCGACATTATTTGG	1	0.985480943738657	GTTTGCGTGCTTGTGTTAGTGTTCCTGT	{23913}
4.757111090344213	7672	7792	120	7672	2	0.9909255898366606	TGGCGGTCATACAATTATGCTGTGTCTAGT TGGCGTTCATACAATTATGTTGTGTCTGGT	7762	3	0.9927404718693285	GCATGCCTTTGGCTTTTACGCAAGTTTTAT GCATGCCTTTGGCTTTTACGTAAGTTCTAT GCATGCTTATGGTTTTTGCGTCGTTTTTAC	1	0.985480943738657	GCGGGTTTGGTACGAATGTATAATTTGT	{7732}
4.806526686365172	29180	29310	130	29180	3	0.9927404718693285	CACGTGCTGTTTCTTTTGCAGATAACAATG CCCGTGCCGTCTCTTTTGCAGATAACAATG CTCGTGCTGTTTCCTTTGCCGATAACAATG	29280	2	0.9927404718693285	AACTGTCTCATGGTACACAGGCCTTACCCA CACTGTCTCTTGGTACACTGGGCTTACCCA	1	0.985480943738657	GGTAGAGGACGTAATCCAAAACCACGAG	{29239}
4.815557335320483	2246	2378	132	2246	3	0.9927404718693285	GCCAAACTGCTGTTAGTAAGCTTCTAGATA GCCAGAAGGCTGTTAGTGCTTTCATTACTA GTCAAAATGCTGTCAGTAAGCTTCTAGACA	2348	2	0.9909255898366606	GCAATGCCTATGTGTACACTTCACAAGGGT GCGGAGCATATGTGTACACTTCACAGGGCT	1	0.9872958257713249	TGTTAGATTTGGCAGGATTGTTCAGAAT	{2312}
4.828643513028185	24105	24240	135	24105	2	0.9909255898366606	GTGCTATGGGTATAGTTAATAGCTCAATGG GTGTCCTAGGACTTGTTAATTCCTCTTTGT	24210	3	0.9909255898366606	AAGGTCGTAGTGCTAGTTCAGGTTATTTAC GCAGTGTGCGCTCTGTTCCAGGTGAAATGC GTGTTGTGAGTGGTGACCCACAACCTATGC	1	0.9872958257713249	TCGTAGAGGACTGCAAGTTGCCTCTTGG	{24135}
4.936505354025413	27554	27719	165	27554	3	0.9909255898366606	ACGCATGTCTCATACCGTTTCTACTTTGTC ATGTGTGTCTCATTCCACTCATGTTATGTC ATGTGTGTCTCATTCCCCTATTATTACTGC	27689	2	0.9909255898366606	ATCCAACTGGAAGTTGCCTGATAGCCTTCT ATCCAACTGGAGGCTTTCTTATAGCCTTCT	1	0.9800362976406534	GCCATTGTATTAGTCAATGGTGTACATT	{27661}
4.989822420167964	23979	24163	184	23979	3	0.9927404718693285	CATTATTTGGTAGTGTAGCTTGTTCGCACA CCTTGTTTGGTAGTGTTGCTTGTCAACATA CTCTATTTGGTAGTGTTGCATGTGAACACA	24133	2	0.9909255898366606	CACTGTTGAAGAATGCAATCTTTCTTTGGG GTTCGTAGAGGACTGCAAGTTGCCTCTTGG	1	0.9872958257713249	TGTGTCCTAGGACTTGTTAATTCCTCTT	{24104}
5.0	3170	3358	188	3170	2	0.9909255898366606	CAACTATGATCTTTTCATTACACCCTGTGG CTACTATGATCTTCTCTCTTCACCCCGTCG	3328	3	0.9909255898366606	TGGACTGCTGCAGTTGATGAAGCGTTCCCT TGGGCTGCTGCAGTTGATGAAGCGTTCCCC TGGTCTGTTGCTGTTGATGAAGCTTTCCCT	1	0.985480943738657	TGACGAGGAGTGTTCTGAAGTAGAGGCT	{3204}
5.048699245246692	24031	24240	209	24031	2	0.9909255898366606	CTCCCGTTCTACGCGATCAATGCTTAAACG TTCTCGTGAAACTAGAGCTTCTCTTGTTTC	24210	3	0.9909255898366606	AAGGTCGTAGTGCTAGTTCAGGTTATTTAC GCAGTGTGCGCTCTGTTCCAGGTGAAATGC GTGTTGTGAGTGGTGACCCACAACCTATGC	1	0.9872958257713249	TGTGTCCTAGGACTTGTTAATTCCTCTT	{24104}
5.055089493487165	23832	24044	212	23832	3	0.9909255898366606	TAGGTGTTAAACAGCAGCGCTTTGTTTATG TAGGTGTTCGACAGCAGCGCTTTGTTTATG TTGGTATTAGGCAGCAGCGCTTTGTTTATG	24014	2	0.9909255898366606	ACAATGGCTGCTCAGTTTTCTCGTGAAACT TCTACCATGTCTCAATACTCCCGTTCTACG	1	0.985480943738657	GTTTGCGTGCTTGTGTTAGTGTTCCTGT	{23913}
5.071532422683973	7675	7895	220	7675	4	0.9909255898366606	CGGTCATACAATTATGCTGTGTCTAGTGCC CGGTCATACAATTATGTTGTGTCTAGTACC CGGTCATACAATTATGTTGTGTCTAGTGCT CGTTCATACAATTATGTTGTGTCTGGTGCA	7865	1	0.9909255898366606	AAGCTTCTACCGTTGTCTGTGGTGGAAAAC	1	0.985480943738657	GCGGGTTTGGTACGAATGTATAATTTGT	{7732}
5.073529730317068	2246	2467	221	2246	3	0.9927404718693285	GCCAAACTGCTGTTAGTAAGCTTCTAGATA GCCAGAAGGCTGTTAGTGCTTTCATTACTA GTCAAAATGCTGTCAGTAAGCTTCTAGACA	2437	2	0.9909255898366606	AAGGGTATGCAACTTTTGCATACAAAGGTC AAGGGTATGCAGCTTTTGCACACTAAAATC	1	0.9872958257713249	TGTTAGATTTGGCAGGATTGTTCAGAAT	{2312}
5.085259093787735	3131	3358	227	3131	2	0.9909255898366606	GCTACTGCTTTAATGCAGATGGTGATGAAG GCTATTGCTTTAACGCTGAGGGTGATGCAT	3328	3	0.9909255898366606	TGGACTGCTGCAGTTGATGAAGCGTTCCCT TGGGCTGCTGCAGTTGATGAAGCGTTCCCC TGGTCTGTTGCTGTTGATGAAGCTTTCCCT	1	0.985480943738657	CACCCCGTCGAGTGTGACGAGGGGTGTT	{3190}
5.1057079683607345	23925	24163	238	23925	3	0.9909255898366606	GTGTCAGTGTGCCTGTTTCTGTGATATATG GTGTTAGTGTGCCTGTTTCAGTGATATATG GTGTTAGTGTTCCTGTTTCTGTCATCTATG	24133	2	0.9909255898366606	CACTGTTGAAGAATGCAATCTTTCTTTGGG GTTCGTAGAGGACTGCAAGTTGCCTCTTGG	1	0.9872958257713249	TGTGTCCTAGGACTTGTTAATTCCTCTT	{24104}
5.126621916171137	22597	22847	250	22597	2	0.9909255898366606	AAAAATGCCTCTCTCAACTCTTTCAAGGAG CGTAATGCCAGTCTGAACTCTTTTAAGGAG	22817	3	0.9909255898366606	CAGTAATACCGCGCTCCGTCATACAACCGT CTATCATTCCTCACAGTATTCGTTCTATCC CTGTAATACCTCGTTCTATTCGCTCTTACC	1	0.9872958257713249	CCTCTTCTCATCTCGGTATGTTGATTTG	{22728}
5.1794942636812	23037	23125	88	23037	3	0.9927404718693285	AGCAAAACCTTCTGGCTCAGTTGTGGAACA AGCTCAACCTCGCGGCGAATTTGTCGAACA GGCCAAACCTGTAGGCGCATATTATGAGGC	23095	3	0.9927404718693285	AAGCTGTTCAAAGCCGCACCTCCCCAAATT CCTCTTCTGTCTGGCACACCTCCTCAGGTT GAATTGTTTAGGGAAAGAGCCCCTACAATC	1	0.985480943738657	GGCTGAAGGTGTTGAATGTGATTTTTCA	{23067}
5.201611090344213	23622	23712	90	23622	3	0.9909255898366606	ACGTCTTACTTATACGGACCATCTTAGTGA TGGCTGCAACAGGCGTCACATCATCTATGA TTGTTGCTAGTGGCTCAACTGTTGCCATGA	23682	3	0.9927404718693285	CAGTTAAATATGAACCAGGAGCAGAAACTG CAGTTCAATATGGTACAGACACCAATAGTG CTGTTCAGTATGGCACTGACACTAACAGTG	1	0.985480943738657	CTGAGCAATTACAGATGGGCTTTGGTAT	{23652}
5.345529642842771	23211	23318	107	23211	3	0.9909255898366606	TAGTCAAATATCTCCAGCAGCAATTGCTAG TCATCAGGTATCACCAAGTGCTCTAGCGTC TGATAAGATTACACCCGAAGCTCTGGCAAC	23288	3	0.9909255898366606	ACCTTGCTTCTTATTTGCAGCAAGGTTCTA CTTGGAAATCTTACCTTGCTATAGGTTCTG GTATGAAATCCGATCTCAGTGTTAGTTCTG	1	0.9836660617059891	TAACTGTTATTCTTCACTGATTTTGGAT	{23241}
5.449470128054923	22970	23095	125	22970	3	0.9927404718693285	CACAACTCCACTGCTCATATGAATCCTTCG CACAGCTGAGGTGTTCTTATGAGTCTTTTG CCCAGCTTATCTGTTCGTATGGTGATTTTA	23065	3	0.9909255898366606	CAACCACAAGGCGTTGAGTGTGATTTCTCC CAGGCTGAAGGTGTTGAATGTGATTTTTCA GCTCATGTGTACCCCGATTGCAATTTTACT	1	0.985480943738657	GAAGCAAAACCTTCTGGCTCAGTTGTGG	{23035}
5.449735466635868	4155	4261	106	4155	3	0.9927404718693285	TACGAAAGGAGCTGTTCAACAAGAGTCAGA TTCAAAAGGGGCTGTCCAAAAAGAGTCAGA TTCCAATGGAGCTGTTCAAATTGAGTCAGA	4231	3	0.9927404718693285	CTCTTGCAAGGCCATTCTCTAGCTAAGAAT CTCTTGCAAGGTCATTCTCTTGCTAAAAAC TTGCTTAAGGGACATGGTTTAGCTAAGCAT	2	0.9836660617059891	TGAATACATTCTGGCTAGGGGTCCATTG TGGGTATATTCTGGCTAAAGGGCCGTTA	{4185} {4185}
5.47777380995394	24494	24625	131	24494	3	0.9927404718693285	GACGAGTCAGTAGCAAGTCTTTTTTCTAAC GATGACTCAGTTCGCAACTTGTTTGAGAGT GATGATTCTGTACGTAATTTGTTTGCGAGC	24595	3	0.9909255898366606	ACCTGAGGTGACCACTAGTCAGTATAGTTA GCTTTCTGTTTCTACTGGTTCTTCTAATGC TGTTTCTATATCTACTGGCAGTCGTAGTGC	1	0.985480943738657	ACCAGGTTTTGGAGGTGACTTTAATTTG	{24553}
5.553789758004454	3170	3320	150	3170	2	0.9909255898366606	CAACTATGATCTTTTCATTACACCCTGTGG CTACTATGATCTTCTCTCTTCACCCCGTCG	3290	4	0.9927404718693285	CTGACTTGCAGCATGAAGATTCTGATGATG GTAGCGATGATGATTTAAGCACAGAACAAG TTGACGTTTCTCATGAGACTTCTGACGACG TTGACGTTTCTCATGAGGTTTCTGACGACG	1	0.985480943738657	TGACGAGGAGTGTTCTGAAGTAGAGGCT	{3204}
5.571121916171137	22970	23125	155	22970	3	0.9927404718693285	CACAACTCCACTGCTCATATGAATCCTTCG CACAGCTGAGGTGTTCTTATGAGTCTTTTG CCCAGCTTATCTGTTCGTATGGTGATTTTA	23095	3	0.9927404718693285	AAGCTGTTCAAAGCCGCACCTCCCCAAATT CCTCTTCTGTCTGGCACACCTCCTCAGGTT GAATTGTTTAGGGAAAGAGCCCCTACAATC	1	0.985480943738657	GAAGCAAAACCTTCTGGCTCAGTTGTGG	{23035}
5.57780063353398	23832	23989	157	23832	3	0.9909255898366606	TAGGTGTTAAACAGCAGCGCTTTGTTTATG TAGGTGTTCGACAGCAGCGCTTTGTTTATG TTGGTATTAGGCAGCAGCGCTTTGTTTATG	23959	3	0.9909255898366606	AGAAACTAAAACCCACGCTACTCTATTTGG CAACACTAACCAATACGCTACCTTGTTTGG GCCATCTGACAAACATGCGACATTATTTGG	1	0.985480943738657	GTTTGCGTGCTTGTGTTAGTGTTCCTGT	{23913}
5.590754591467449	4155	4316	161	4155	3	0.9927404718693285	TACGAAAGGAGCTGTTCAACAAGAGTCAGA TTCAAAAGGGGCTGTCCAAAAAGAGTCAGA TTCCAATGGAGCTGTTCAAATTGAGTCAGA	4286	3	0.9909255898366606	CCCGCGCTAAACAGGATGTTTCTCTCCTTA CTAGAGCAAAACAGGATGTGTCCTTACTTA CTCGTGCAAAGCAAGATGTTTCTCTTCTTA	1	0.9818511796733213	TGGGTATATTCTGGCTAAAGGGCCGTTA	{4185}
5.593357335320481	23513	23645	132	23513	3	0.9927404718693285	CCAGTCAACAATGTATTACTGGTGCTCTTA CTAATCAATACTCACCCTGTGTATCCATTG CTGGACAATACACCCCATGCCTTTATCTTA	23615	3	0.9909255898366606	GAGTGTCACGCCTTACTTATACGGACCATC GGAACCCTTGTAGGAGTTGGCAACACAGTC GGCTGGCTTGTTGCTAGTGGCTCAACTGTT	2	0.985480943738657	CCCATCCACTGTGTGGGAAGATGGTGAT TCCACTGTGTGGGAAGACGGTGATTATT	{23544} {23548}
5.6351433771173465	23211	23387	176	23211	3	0.9909255898366606	TAGTCAAATATCTCCAGCAGCAATTGCTAG TCATCAGGTATCACCAAGTGCTCTAGCGTC TGATAAGATTACACCCGAAGCTCTGGCAAC	23357	3	0.9909255898366606	CCAATCCTACGTGTAGGATTTTTGCAACTG CTAATCCCACATGTTTGATTTTAGCGACTG GCAATCCTACTTGTAGGATATTAGCTTCAG	1	0.9836660617059891	TAACTGTTATTCTTCACTGATTTTGGAT	{23241}
5.637895040691433	23535	23712	177	23535	3	0.9909255898366606	ATCCATTGTCCCATCCACTGTGTGGGAAGA GGGCTTTGCTCCTAATGGTTTATCCGAAGA TGCTCTTAACTCTCCTACAACTGGTCAACT	23682	3	0.9927404718693285	CAGTTAAATATGAACCAGGAGCAGAAACTG CAGTTCAATATGGTACAGACACCAATAGTG CTGTTCAGTATGGCACTGACACTAACAGTG	1	0.985480943738657	TGACTGAGCAATTACAGATGGGCTTTGG	{23649}
5.6691946961550475	3131	3320	189	3131	2	0.9909255898366606	GCTACTGCTTTAATGCAGATGGTGATGAAG GCTATTGCTTTAACGCTGAGGGTGATGCAT	3290	4	0.9927404718693285	CTGACTTGCAGCATGAAGATTCTGATGATG GTAGCGATGATGATTTAAGCACAGAACAAG TTGACGTTTCTCATGAGACTTCTGACGACG TTGACGTTTCTCATGAGGTTTCTGACGACG	1	0.985480943738657	CACCCCGTCGAGTGTGACGAGGGGTGTT	{3190}
5.695426686365171	23038	23238	200	23038	3	0.9927404718693285	GCAAAACCTTCTGGCTCAGTTGTGGAACAG GCCAAACCTGTAGGCGCATATTATGAGGCT GCTCAACCTCGCGGCGAATTTGTCGAACAA	23208	3	0.9909255898366606	ATGTGATAAGATTACACCCGAAGCTCTTGC TTGTAGTCAAATATCTCCAGCAGCAATTGC TTGTCATCAGGTATCACCAAGTGCTTTAGC	1	0.985480943738657	GCTGAAGGTGTTGAATGTGATTTTTCAC	{23068}
5.713240537842752	23110	23318	208	23110	3	0.9927404718693285	ACACCTCCTCAGGTTTATAATTTCAAGCGT AGAGCCCCTACAATCATGCAGTATAAGCGT GCACCTCCCCAAATTTATAATTTCAGTAGG	23288	3	0.9909255898366606	ACCTTGCTTCTTATTTGCAGCAAGGTTCTA CTTGGAAATCTTACCTTGCTATAGGTTCTG GTATGAAATCCGATCTCAGTGTTAGTTCTG	1	0.9836660617059891	TAACTGTTATTCTTCACTGATTTTGGAT	{23241}
5.719673533078033	23622	23833	211	23622	3	0.9909255898366606	ACGTCTTACTTATACGGACCATCTTAGTGA TGGCTGCAACAGGCGTCACATCATCTATGA TTGTTGCTAGTGGCTCAACTGTTGCCATGA	23803	3	0.9909255898366606	CACGGGTGTTTTCCAGCTATGCAACGCAAC CCGTGGTGTTTTTCAGAATTGCACAGCTGT TAGAGGTGTATTTCAAAACTGCACAGCTGT	1	0.985480943738657	CTGAGCAATTACAGATGGGCTTTGGTAT	{23652}
5.738232422683972	24494	24714	220	24494	3	0.9927404718693285	GACGAGTCAGTAGCAAGTCTTTTTTCTAAC GATGACTCAGTTCGCAACTTGTTTGAGAGT GATGATTCTGTACGTAATTTGTTTGCGAGC	24684	3	0.9909255898366606	TGCAAGGTTACGATGATTGTATGCAGCAAG TGCAAGGTTATGATGAATGCATGCAACAAG TGCAAGGTTATGATGAGTGCATGAAGCAAG	1	0.985480943738657	ACCAGGTTTTGGAGGTGACTTTAATTTG	{24553}
5.751959093787734	22867	23094	227	22867	3	0.9927404718693285	GCGGCGTTTTACATATATCCACTACATCAA GCTGCCTTCTACGTATATAAACTTCAACCG GCTGCGTTTTATGTGTACAAACTCTACCCA	23064	3	0.9927404718693285	ACAACCACAAGGCGTGGAGTGTGATTTCTC ACAGGCTGAAGGTGTTGAATGTGATTTTTC GGCTCATGTGTACCCCGATTGCAATTTTAC	1	0.985480943738657	GAAGCAAAACCTTCTGGCTCAGTTGTGG	{23035}
5.770601953228442	4137	4374	237	4137	3	0.9909255898366606	CGCTGCTATTAATGCAGCTACGAAAGGAGC TGCTGCTATAAATAAGGCATCTCATGGCTC TGGTGCTATTAATGCGGCTTCAAAAGGGGC	4344	3	0.9909255898366606	TCCTCTCGTAGTAACTCCTCTTGTATCTGC TCCTCTTGTAGTCACTCCTCTTGTTTCAGC TTCAATTGTGGTAACACCTTTAGTGTCAGC	1	0.9818511796733213	GATGGGTATATTCTGGCTAAAGGGCCGT	{4183}
5.7830354666358685	3076	3320	244	3076	2	0.9909255898366606	CTACGTGGTAAGCAAATTCCCGATTTTGAT CTGCGTGGAATGCCGATTCCAGATTTTGAT	3290	4	0.9927404718693285	CTGACTTGCAGCATGAAGATTCTGATGATG GTAGCGATGATGATTTAAGCACAGAACAAG TTGACGTTTCTCATGAGACTTCTGACGACG TTGACGTTTCTCATGAGGTTTCTGACGACG	1	0.985480943738657	CACCCCGTCGAGTGTGACGAGGGGTGTT	{3190}
5.793321916171137	7675	7925	250	7675	4	0.9909255898366606	CGGTCATACAATTATGCTGTGTCTAGTGCC CGGTCATACAATTATGTTGTGTCTAGTACC CGGTCATACAATTATGTTGTGTCTAGTGCT CGTTCATACAATTATGTTGTGTCTGGTGCA	7895	2	0.9909255898366606	GTACGTTTTACATTGCAGCTAATGGCGGTA GTACGTTTTATATCACAGCAAATGGCGGTA	1	0.985480943738657	GCGGGTTTGGTACGAATGTATAATTTGT	{7732}
5.793321916171137	24494	24744	250	24494	3	0.9927404718693285	GACGAGTCAGTAGCAAGTCTTTTTTCTAAC GATGACTCAGTTCGCAACTTGTTTGAGAGT GATGATTCTGTACGTAATTTGTTTGCGAGC	24714	3	0.9909255898366606	GACCACCTTCTGCTAGAGACCTAATTTGTG GTCCACAATCTGCTCGCGACTTGATTTGTG GTCCAGCATCAGCTCGTGATCTTATTTGTG	1	0.985480943738657	ACCAGGTTTTGGAGGTGACTTTAATTTG	{24553}
5.793321916171137	29180	29430	250	29180	3	0.9927404718693285	CACGTGCTGTTTCTTTTGCAGATAACAATG CCCGTGCCGTCTCTTTTGCAGATAACAATG CTCGTGCTGTTTCCTTTGCCGATAACAATG	29400	3	0.9927404718693285	GAGACAGGACAGAAAAATTAATACCGGGAA GAGACAGGACAGAAAGATTAACACAGGAAA GCGCCAGGACAGAAAAATTAATACAGGAAA	1	0.985480943738657	GGTAGAGGACGTAATCCAAAACCACGAG	{29239}
6.2344296428427715	4052	4206	154	4052	4	0.9909255898366606	ACGCAATTCAAGTAGCAAAATGCTACGAAC ACGCAATTCAAGTAGCCAAGTGCTATGGGG ACGCAATTCTAGTAGCCAAGTGCTATGGTG ACGCTATTAAGCTAGCCAAGTGCTTTAAAG	4176	3	0.9909255898366606	AGAGTCAGATGAGTATATTCTGACTAGAGG AGAGTCAGATGAGTATATTCTGGCTAAAGG TGAGTCAGATGAATATCTGACTCAGCGTGG	1	0.985480943738657	TAATGCGGCTTCAAAAGGGGCTGTCCAG	{4146}
6.323222420167964	4052	4236	184	4052	4	0.9909255898366606	ACGCAATTCAAGTAGCAAAATGCTACGAAC ACGCAATTCAAGTAGCCAAGTGCTATGGGG ACGCAATTCTAGTAGCCAAGTGCTATGGTG ACGCTATTAAGCTAGCCAAGTGCTTTAAAG	4206	3	0.9909255898366606	ACCACTTCAGGTTGGTGATGCTGTCTTGCT GCCGTTACAAGTAGGAGATTCAGTTCTCTT TCCATTGCAAGTAGGCGAATCTGCTCTCTT	1	0.985480943738657	TAATGCGGCTTCAAAAGGGGCTGTCCAG	{4146}
6.3575141342961095	24427	24625	198	24427	4	0.9927404718693285	ACTACTCGAGTATGGCCAGTTTTGTTCCAA ACTGCGCGAGTATGGCCAGTTTTGTTCCAA ATTAGTTGAATATGGCCAGTTCTGCGCTAA GCTTGAACAATATGGCCAGTTTTGCTCAAA	24595	3	0.9909255898366606	ACCTGAGGTGACCACTAGTCAGTATAGTTA GCTTTCTGTTTCTACTGGTTCTTCTAATGC TGTTTCTATATCTACTGGCAGTCGTAGTGC	1	0.985480943738657	ACCAGGTTTTGGAGGTGACTTTAATTTG	{24553}
6.3575141342961095	27591	27789	198	27591	3	0.9909255898366606	AGACACATGTGTGCGTAGTATGGTAAAGAC AGATACTTGTCGTCGCAGCATTATCAGAAC GGATACTTGTCGTCGCAGCATTTGTAGGAC	27759	4	0.9909255898366606	TTTCTGCCTCATGCTGAGTTCTTATATTCC TTTCTGTCTCATGCTGAATTCCTACATTCC TTTCTGTCTCATGCTGAATTCCTTCCTACC TTTCTGTCTCATGCTGAGGTCCTATATTCC	1	0.9818511796733213	ATGGTTTACATTATCCAACTGGAAGTTG	{27677}
6.418659093787735	4052	4279	227	4052	4	0.9909255898366606	ACGCAATTCAAGTAGCAAAATGCTACGAAC ACGCAATTCAAGTAGCCAAGTGCTATGGGG ACGCAATTCTAGTAGCCAAGTGCTATGGTG ACGCTATTAAGCTAGCCAAGTGCTTTAAAG	4249	3	0.9927404718693285	CTAGCTAAGAATATCCTGCATGTCGTAGGC CTTGCTAAAAACATCTTGCATGTTGTAGGC TTAGCTAAGCATATCCTGCATGTTGTAGGA	1	0.985480943738657	TAATGCGGCTTCAAAAGGGGCTGTCCAG	{4146}
6.420572931341441	27591	27819	228	27591	3	0.9909255898366606	AGACACATGTGTGCGTAGTATGGTAAAGAC AGATACTTGTCGTCGCAGCATTATCAGAAC GGATACTTGTCGTCGCAGCATTTGTAGGAC	27789	4	0.9909255898366606	ACTGTTTGACATGCGTTCCCACTTCATTCG ACTGTTTGACATGCGTTCTCACTTTATTCG ACTTATTGACATGCGCTCGCATTTTGTGCG CCTGTTTGACATGCGTTCCCACTTTATTCG	1	0.9818511796733213	ATGGTTTACATTATCCAACTGGAAGTTG	{27677}
