cost	target-start	target-end	target-length	left-primer-start	left-primer-num-primers	left-primer-frac-bound	left-primer-target-sequences	right-primer-start	right-primer-num-primers	right-primer-frac-bound	right-primer-target-sequences	num-guides	total-frac-bound-by-guides	guide-target-sequences	guide-target-sequence-positions
2.8109738099539405	22225	22356	131	22225	1	1.0	GGCTTTAGAACCATTGGTAGATTTGCCAAT	22326	1	1.0	CTTCAGGTTGGACAGCTGGTGCTGCAGCTT	1	1.0	AGAAGTTATTTGACTCCTGGTGATTCTT	{22298}
2.8154573353204815	21904	22036	132	21904	1	1.0	CCAGTCCCTACTTATTGTTAATAACGCTAC	22006	1	1.0	CAACAAAAGTTGGATGGAAAGTGAGTTCAG	1	1.0	TTCAATTTTGTAATGATCCATTTTTGGG	{21960}
2.8154573353204815	22309	22441	132	22309	1	1.0	GACTCCTGGTGATTCTTCTTCAGGTTGGAC	22411	1	1.0	AACCATTACAGATGCTGTAGACTGTGCACT	1	1.0	AGCTGGTGCTGCAGCTTATTATGTGGGT	{22339}
2.849232422683972	23539	23679	140	23539	1	1.0	ATATGAGTGTGACATACCCATTGGTGCAGG	23649	1	1.0	CTATGTCACTTGGTGCAGAAAATTCAGTTG	1	1.0	CTAATTCTCCTCGGCGGGCACGTAGTGT	{23595}
2.927112910986066	22309	22471	162	22309	1	1.0	GACTCCTGGTGATTCTTCTTCAGGTTGGAC	22441	1	1.0	TGACCCTCTCTCAGAAACAAAGTGTACGTT	1	1.0	AGCTGGTGCTGCAGCTTATTATGTGGGT	{22339}
2.9333377053709504	22225	22389	164	22225	1	1.0	GGCTTTAGAACCATTGGTAGATTTGCCAAT	22359	1	1.0	ATGTGGGTTATCTTCAACCTAGGACTTTTC	1	1.0	AGAAGTTATTTGACTCCTGGTGATTCTT	{22298}
2.9424539643783345	3305	3472	167	3305	1	1.0	TGGAACTTACACCAGTTGTTCAGACTATTG	3442	1	1.0	GCAGCCAATGTTTACCTTAAACATGGAGGA	1	1.0	AAGTGAATAGTTTTAGTGGTTATTTAAA	{3335}
2.9765285070070253	22687	22866	179	22687	1	1.0	CACTTTTAAGTGTTATGGAGTGTCTCCTAC	22836	1	1.0	TACCAGATGATTTTACAGGCTGCGTTATAG	1	1.0	ATTTGTAATTAGAGGTGATGAAGTCAGA	{22759}
2.992297268051916	21904	22089	185	21904	1	1.0	CCAGTCCCTACTTATTGTTAATAACGCTAC	22059	1	1.0	GCACTTTTGAATATGTCTCTCAGCCTTTTC	1	1.0	TTCAATTTTGTAATGATCCATTTTTGGG	{21960}
3.0216827288338286	3305	3502	197	3305	1	1.0	TGGAACTTACACCAGTTGTTCAGACTATTG	3472	1	1.0	GGTGTTGCAGGAGCCTTAAATAAGGCTACT	1	1.0	AAGTGAATAGTTTTAGTGGTTATTTAAA	{3335}
3.0376573353204814	3216	3420	204	3216	1	1.0	TCAACAAACTGTTGGTCAACAAGACGGCAG	3390	1	1.0	TGCAGACATTGTGGAAGAAGCTAAAAAGGT	1	1.0	CTATTGAAGTGAATAGTTTTAGTGGTTA	{3329}
3.057091578646307	23539	23752	213	23539	1	1.0	ATATGAGTGTGACATACCCATTGGTGCAGG	23722	1	1.0	TAGTGTTACCACAGAAATTCTACCAGTGTC	1	1.0	CTAATTCTCCTCGGCGGGCACGTAGTGT	{23595}
3.0633163730311916	22225	22441	216	22225	1	1.0	GGCTTTAGAACCATTGGTAGATTTGCCAAT	22411	1	1.0	AACCATTACAGATGCTGTAGACTGTGCACT	1	1.0	AGAAGTTATTTGACTCCTGGTGATTCTT	{22298}
3.0653647304037195	21904	22121	217	21904	1	1.0	CCAGTCCCTACTTATTGTTAATAACGCTAC	22091	1	1.0	ATGGACCTTGAAGGAAAACAGGGTAATTTC	1	1.0	TTCAATTTTGTAATGATCCATTTTTGGG	{21960}
3.087072931341441	22638	22866	228	22638	1	1.0	GCAACTGTGTTGCTGATTATTCTGTCCTAT	22836	1	1.0	TACCAGATGATTTTACAGGCTGCGTTATAG	1	1.0	ATTTGTAATTAGAGGTGATGAAGTCAGA	{22759}
3.098322044777587	3216	3450	234	3216	1	1.0	TCAACAAACTGTTGGTCAACAAGACGGCAG	3420	1	1.0	AAAACCAACAGTGGTTGTTAATGCAGCCAA	1	1.0	CTATTGAAGTGAATAGTTTTAGTGGTTA	{3329}
3.1074038657081178	22093	22332	239	22093	1	1.0	GGACCTTGAAGGAAAACAGGGTAATTTCAA	22302	1	1.0	GTTATTTGACTCCTGGTGATTCTTCTTCAG	1	1.0	GTGCGTGATCTCCCTCAGGGTTTTTCGG	{22199}
3.1144885040667143	3176	3419	243	3176	1	1.0	CTGAAGAAGAGCAAGAAGAAGATTGGTTAG	3389	1	1.0	ATGCAGACATTGTGGAAGAAGCTAAAAAGG	1	1.0	CTATTGAAGTGAATAGTTTTAGTGGTTA	{3329}
3.1197010878282048	22225	22471	246	22225	1	1.0	GGCTTTAGAACCATTGGTAGATTTGCCAAT	22441	1	1.0	TGACCCTCTCTCAGAAACAAAGTGTACGTT	1	1.0	AGAAGTTATTTGACTCCTGGTGATTCTT	{22298}
3.1248302666619225	3305	3554	249	3305	1	1.0	TGGAACTTACACCAGTTGTTCAGACTATTG	3524	1	1.0	CTGATGATTACATAGCTACTAATGGACCAC	1	1.0	AAGTGAATAGTTTTAGTGGTTATTTAAA	{3335}
3.473126686365171	22687	22817	130	22687	1	1.0	CACTTTTAAGTGTTATGGAGTGTCTCCTAC	22787	2	1.0	CAAATCGCTCCAGGGCAAACTGGAAAAATT CAAATCGCTCCAGGGCAAACTGGAAAGATT	1	1.0	ATTTGTAATTAGAGGTGATGAAGTCAGA	{22759}
3.643228507007025	22638	22817	179	22638	1	1.0	GCAACTGTGTTGCTGATTATTCTGTCCTAT	22787	2	1.0	CAAATCGCTCCAGGGCAAACTGGAAAAATT CAAATCGCTCCAGGGCAAACTGGAAAGATT	1	1.0	ATTTGTAATTAGAGGTGATGAAGTCAGA	{22759}
3.7881199489870325	23565	23812	247	23565	2	1.0	CAGGCATATGCGCTAGTTATCAGACTCAGA CAGGTATATGCGCTAGTTATCAGACTCAGA	23782	1	1.0	GTACATTTGTGGTGATTCAACTGAATGCAG	1	1.0	CTAATTCTCCTCGGCGGGCACGTAGTGT	{23595}
