cost	target-start	target-end	target-length	left-primer-start	left-primer-num-primers	left-primer-frac-bound	left-primer-target-sequences	right-primer-start	right-primer-num-primers	right-primer-frac-bound	right-primer-target-sequences	num-guides	total-frac-bound-by-guides	guide-target-sequences	guide-target-sequence-positions
2.997385737400775	30154	30341	187	30154	1	0.9969879518072289	AACAACATTGCCAAAAGGCTTCTACGCAGA	30311	1	0.9909638554216867	ACTGCCCTCGCGCTATTGCTGCTAGACAGA	1	0.9819277108433735	TGCTCGAATGGCTAGCGGAGGTGGTGAA	{30283}
3.1793942636811994	30253	30341	88	30253	2	0.9909638554216867	AACGCCTAGCAGTAGCAGAGGTTCATCACC AACTCCTGGCAGCAGTAGGGGAAATTCTCC	30311	1	0.9909638554216867	ACTGCCCTCGCGCTATTGCTGCTAGACAGA	1	0.9819277108433735	TGCTCGAATGGCTAGCGGAGGTGGTGAA	{30283}
3.596940417140111	30255	30418	163	30255	2	0.9909638554216867	CGCCTAGCAGTAGCAGAGGTTCATCACCAG CTCCTGGCAGCAGTAGGGGAAATTCTCCTG	30388	1	0.9909638554216867	AGGCCAAACTGTCACTAAGAAATCTGCTGC	1	0.9849397590361446	CTCGAATGGCTAGCGGAGGTGGTGAAAC	{30285}
3.7723079683607335	30157	30395	238	30157	2	0.9939759036144579	AACATTGCCAAAAGGCTTCTACGCAGAGGG AACATTGCCCAAAGGCTTCTACGCAGAAGG	30365	1	0.9909638554216867	TCTGGTAAAGGCCAACAACAACAAGGCCAA	1	0.9819277108433735	TGCTCGAATGGCTAGCGGAGGTGGTGAA	{30283}
3.919808310503012	1162	1363	201	1162	1	0.9909638554216867	GTCAAAGTCATTCAACCACGTGTTGAAAAG	1333	2	0.9909638554216867	AAAGCCACTTGTGAACATTGTGGCACTGAA AGAGCCACTTGCGAATTCTGTGGTACTGAA	3	0.9909638554216867	ACTGAAGGTTTCATGGGGCGTATACGCT GAAGGTTTCATGGGGCGCATTCGCTCTG GCACTTGTCTACCTTGATGAAATGTAGT	{1198} {1201} {1266}
4.010319948987033	26981	27228	247	26981	2	0.9909638554216867	ACTCCTGGAACAATGGAACCTAGTAATAGG GCTCTTAGAACAATGGAACCTAGTAATAGG	27198	1	0.9909638554216867	GTAGGCTTGATGTGGCTTAGCTACTTCGTT	3	0.9849397590361446	AATTAATTGGGTGACTGGCGGGATTGCG GTGACTGGCGGGATTGCGATTGCAATGG TCTTGTTTCTTACATGGATTTGTTTGTT	{27152} {27162} {27013}
4.442489758004454	516	756	240	516	2	0.9909638554216867	GCCCTATGTGTTCATTAAACGATCTGAAGC GCCCTATGTGTTCATTAAACGTTCTGATGC	726	1	0.9909638554216867	TGGCATCGATCTAAAGTCTTATGACTTAGG	7	0.9759036144578314	AAGGTCGTTGAATTGGTTGCAGAATTGG ATCACTGCCACAAGGTCGTTGAGCTGGT CACAAGGTTGTGGAATTGGTTGCAGAAT GCTAGTTGCTGAATTGGATGGCGTGCAG TAAGGTTGTTGAATTGGTGGCTGAAATG TAGCGGTATAACTCTGGGAGTGCTCGTG TCGTTGAGTTGGTTGCAGAAAAGGAAGG	{568} {557} {565} {579} {567} {615} {572}
4.451372960526725	30255	30500	245	30255	2	0.9909638554216867	CGCCTAGCAGTAGCAGAGGTTCATCACCAG CTCCTGGCAGCAGTAGGGGAAATTCTCCTG	30470	2	0.9909638554216867	GTCACCCAAGCTTTTGGGCGACGTGGTCCA GTCACTCAAGCATTTGGGAGACGTGGTCCA	1	0.9849397590361446	CTCGAATGGCTAGCGGAGGTGGTGAAAC	{30285}
4.52579679600542	27127	27352	225	27127	2	0.9909638554216867	GCTTTGTGCTTGCTGCTGTTTACAGAATTA GTTTTGTGCTTGCTGCTGTCTACAGAATTA	27322	2	0.9909638554216867	TAACCAGACCGCTTCTGGAGAGTGAATTAG TGACCAGACCGCTCATGGAAAGTGAACTTG	2	0.9759036144578314	GTGACTGGCGGGATTGCGATTGCAATGG TTGGGTGACTGGCGGGATTGCGACTGCA	{27162} {27158}
4.668331969052151	1162	1404	242	1162	1	0.9909638554216867	GTCAAAGTCATTCAACCACGTGTTGAAAAG	1374	3	0.9939759036144579	AGAAGGTGCCACAACTTGTGGTTACTTACC TGAAGGACCCACTACATGTGGATACCTACC TGAAGGACCTACTACATGTGGGTACCTACC	3	0.9909638554216867	ACTGAAGGTTTCATGGGGCGTATACGCT GAAGGTTTCATGGGGCGCATTCGCTCTG GCACTTGTCTACCTTGATGAAATGTAGT	{1198} {1201} {1266}
4.913014134296109	27127	27256	129	27127	2	0.9909638554216867	GCTTTGTGCTTGCTGCTGTTTACAGAATTA GTTTTGTGCTTGCTGCTGTCTACAGAATTA	27226	3	0.9909638554216867	TTGCATCATTCAGGCTTTTTGCACGCACTA TTGCTTCCTTCAGGCTGTTTGCTCGTACCC TTGCTTCTTTCAGGCTGTTTGCTCGCACCC	2	0.9759036144578314	GTGACTGGCGGGATTGCGATTGCAATGG TTGGGTGACTGGCGGGATTGCGACTGCA	{27162} {27158}
5.014685018119717	30255	30449	194	30255	2	0.9909638554216867	CGCCTAGCAGTAGCAGAGGTTCATCACCAG CTCCTGGCAGCAGTAGGGGAAATTCTCCTG	30419	3	0.9909638554216867	GAGGCATCCAAAAAGCCTCGCCAAAAACGT GAGGCATCGAAGAAGCCTCGCCAAAAACGT GAGGCATCTAAAAAGCCTCGCCAAAAACGT	1	0.9849397590361446	CTCGAATGGCTAGCGGAGGTGGTGAAAC	{30285}
5.439351599001681	516	639	123	516	2	0.9909638554216867	GCCCTATGTGTTCATTAAACGATCTGAAGC GCCCTATGTGTTCATTAAACGTTCTGATGC	609	3	0.9909638554216867	CGGTCGTAGCGGTACAACACTGGGAGTTCT CGGTCGTAGCGGTATAACACTGGGAGTACT CGGTCGTAGCGGTATAACTCTGGGAGTGCT	7	0.9759036144578314	ATCACTGCCACAAGGTCGTTGAGCTGGT CACAAGGTTGTGGAATTGGTTGCAGAAT GCTAGTTGCTGAATTGGATGGCGTGCAG TAAGGTTGTTGAATTGGTGGCTGAAATG TCGTAGAGCTGGTTGCAGAATTGGATGG TCGTTGAGTTGGTTGCAGAAAAGGAAGG TCGTTGAGTTGGTTGCAGAATTGGACGG	{557} {565} {579} {567} {572} {572} {572}
5.753872931341441	787	1015	228	787	2	0.9909638554216867	TATGAACAAAACTGGAACACTAAGCATGGC TATGAACAACAATGGAACACTAAGCATGGC	985	4	0.9909638554216867	CAGTCTAAGAGAGGTGTGTACTGTTGCCGT GAATCGAAGAGAGGCGTCTACTGCTGCCGT GAATCGAAGCGTGGTGTCTATTGCTGCCGT GAGTCGAAGAGAGGTGTCTACTGCTGCCGT	1	0.9849397590361446	GCGGGCAAGTCAATGTGCACTCTTTCTG	{940}
6.0034885040667145	5631	5874	243	5631	4	0.9909638554216867	AGAAACTATGACCCATCTTCTACAACATGC AGAAACTATGACCCATCTTCTACAGCATGC AGAAACTATGACCCATCTTTTACAGCATGC AGAAACTATGACTCATCTTTTACAGCACGC	5844	2	0.9909638554216867	AGAGTCACCTTTTGTTATGATGTCTGCACC AGAGTCTTCTTTTGTTATGATGTCTGCACC	3	0.9759036144578314	AGGTGTTTCCATTCCATGTGTGTGTGGT CAGGTGTTTCAATTCCATGTGTGTGTGG TATGATGAGCTTAAGGCAGGTGTTTCAA	{5787} {5786} {5770}
6.482257335320481	9495	9627	132	9495	5	0.9909638554216867	GGAGTATTCTGTGGTGTTGATGCAATGAAT GGAGTCTTTTGTGGTGTTGATGCCATGAAT GGAGTTTTCTGTGGTGTCGATGCTATGAAC GGAGTTTTCTGTGGTGTTGATGCGATGAAT GGAGTTTTTTGTGGTGTAGATGCTGTGAAT	9597	2	0.9909638554216867	GGTGGTATTATCGCCATACTGGTGACTTGT GGTGGTATTATTGCCATATTGGTGACTTGT	4	0.9759036144578314	GCTCTAGATGTGTCTGCTTCAGTAGTGG GCTTTAGATGTGTCTGCTTCAGTAGTGG GCTTTAGATGTGTCTGCTTCCGTAGTGG GTGCAACCTGTGGGTGCTTTAGATGTGT	{9567} {9567} {9567} {9552}
6.570285018119717	9496	9690	194	9496	5	0.9909638554216867	GAGTATTCTGTGGTGTTGATGCAATGAATC GAGTCTTTTGTGGTGTTGATGCCATGAATC GAGTTTTCTGTGGAGTCGATGCTATGAATC GAGTTTTCTGTGGTGTCGATGCTATGAACC GAGTTTTCTGTGGTGTTGATGCGATGAATC	9660	2	0.9909638554216867	TTTGGTGAATACAACCATGTTGTTGCTGCC TTTGGTGAGTACAACCATGTTGTTGCTGCT	3	0.9879518072289156	AGCAGGTGGTATCATTGCCATATTGGTG GCTTTAGATGTGTCTGCTTCAGTAGTGG GGGTGGTATTATTGCCATATTGGTGACT	{9593} {9567} {9596}
6.571121916171137	27132	27382	250	27132	4	0.9909638554216867	GTGCTCGCTGCTGTTTATAGAATAAACTGG GTGCTTGCTGCTGTCTACAGAATTAATTGG GTGCTTGCTGCTGTTTACAGAATAAACTGG GTGCTTGCTGCTGTTTACAGAATCAATTGG	27352	3	0.9909638554216867	TCATAGGCGCTGTGATCATTCGTGGTCACT TCATTGGCGCTGTGATCATTCGTGGTCACC TCATTGGTGCTGTGATCATTCGTGGTCACT	2	0.9849397590361446	GTGACTGGCGGGATTGCGATTGCAATGG TGTGCCTCTTCGGGGGACAATTTTGACC	{27162} {27299}
6.673672960526725	9445	9690	245	9445	5	0.9909638554216867	CTACCAGTGGTAGATGGGTTCTTAATAATG CTACTAATGGCCGATGGGTTCTTAACAATG CTACTAATGGGCGGTGGGTTCTTAATAATG CTACTAGCGGTAGATGGGTTCTTAATAATG CTACTAGTGGTAGATGGGTACTTAACAATG	9660	2	0.9909638554216867	TTTGGTGAATACAACCATGTTGTTGCTGCC TTTGGTGAGTACAACCATGTTGTTGCTGCT	3	0.9879518072289156	AGCAGGCGGTATTATTGCCATATTGGTG GGGTGGTATTATTGCCATATTGGTGACT TGTGGTGTTGATGCAATGAATCTTATAG	{9593} {9596} {9504}
6.730216373031191	9559	9658	99	9559	5	0.9909638554216867	CTATTGGTGCTTTGGACATATCTGCATCTA CTGTCGGTGCTCTAGATGTGTCTGCTTCAG CTGTGGGTGCTTTAGATGTGTCTGCTTCAG CTGTGGGTGCTTTAGATGTTTCTGCTTCAG CTGTTGGTGCTTTAGATGTATCTGCTTCTG	9628	3	0.9909638554216867	CTGCCTACTACTTTATGAAATTCAGACGTG CTGCCTACTATTTCATGAAGTTTAGACGTG CTGCTTACTACTTTATGAAATTCAGGCGTG	2	0.9819277108433735	AGCAGGTGGTATCATTGCCATATTGGTG GGGTGGTATTATTGCCATATTGGTGACT	{9593} {9596}
6.7877643733214486	889	1015	126	889	4	0.9909638554216867	TGTGGCCCAGATGGCTACCCCCTTGAATGC TGTGGCCCAGATGGGTACCCTCTTGATTGC TGTGGCCCGGATGGGTATCCTCTTGAATGC TGTGGCCCTGATGGGTATCCTCTTGACTGC	985	4	0.9909638554216867	CAGTCTAAGAGAGGTGTGTACTGTTGCCGT GAATCGAAGAGAGGCGTCTACTGCTGCCGT GAATCGAAGCGTGGTGTCTATTGCTGCCGT GAGTCGAAGAGAGGTGTCTACTGCTGCCGT	1	0.9849397590361446	GCGGGCAAGTCAATGTGCACTCTTTCTG	{940}
6.793321916171137	25874	26124	250	25874	2	0.9909638554216867	TGCACTTCTTGCTGTTTTTCAAAGCGCTTC TGCATTTCTTGCTGTTTTTCAGAGCGCTAC	26094	5	0.9909638554216867	ATCATGAGATGCTGGCTGTGCTGGAAGTGC ATCATGAGATGCTGGCTTTGTTGGAAGTGC ATTATGAGATGCTGGCTTTGCTGGAAGTGC ATTATGAGATGTTGGCTTTGTTGGAAGTGC TTATTAAGGTGTTGGCTTTGCTGGAAATGC	4	0.9819277108433735	AGAGATGGCAGCTCGCTTTGTGTAAAGG AGTAATTGCGCTTCATAGAAGGTGGCAG CATCTTTTGCTTGTCGCTGCAGGTATGG TTGCGCTTCATAAGAGGTGGCAGCTTGC	{25924} {25907} {26001} {25912}
7.038412910986065	9496	9658	162	9496	5	0.9909638554216867	GAGTATTCTGTGGTGTTGATGCAATGAATC GAGTCTTTTGTGGTGTTGATGCCATGAATC GAGTTTTCTGTGGAGTCGATGCTATGAATC GAGTTTTCTGTGGTGTCGATGCTATGAACC GAGTTTTCTGTGGTGTTGATGCGATGAATC	9628	3	0.9909638554216867	CTGCCTACTACTTTATGAAATTCAGACGTG CTGCCTACTATTTCATGAAGTTTAGACGTG CTGCTTACTACTTTATGAAATTCAGGCGTG	2	0.9819277108433735	AGCAGGTGGTATCATTGCCATATTGGTG GGGTGGTATTATTGCCATATTGGTGACT	{9593} {9596}
7.098426723086379	3578	3761	183	3578	5	0.9909638554216867	AAACATGGAGGAGGTGTTGCTGGAGCTTTA AAACATGGTGGTGGCGTAGCGGGTGCACTC AAACATGGTGGTGGTGTAGCAGGTGCACTC AAACATGGTGGTGGTGTAGCGGGTGCTCTT AAACATGGTGGTGGTGTAGCTGGTGCTCTA	3731	3	0.9909638554216867	GTTGTTGGACCTAACCTAAATGCAGGTGAG GTTGTTGGACCTAACTTAAATGCCGGTGAG GTTGTTGGCCCAAACCTAAATGCTGGTGAG	2	0.9879518072289156	CTCACAGTGGGAGGTTCATGTTTGCTTT GGGTCATGTTTGCTTTCTGGACACAATC	{3671} {3683}
7.116335466635869	464	708	244	464	5	0.9909638554216867	GAACATGTGGCATTATCAGTCTCCAGAAGG GCACTTGTGGCTTAGTAGAAGTTGAAAAAG GCACTTGTGGCTTAGTAGAGCTGGAAAAAG GCACTTGTGGTCTAGTAGAGCTGGAAAAAG GCACTTGTGGTTTAGTGGAGCTGGAAAAAG	678	2	0.9909638554216867	TGTTCTTCTCCGTAAGAATGGTAATAAGGG TGTTCTTCTTCGTAAGAACGGTAATAAGGG	7	0.9759036144578314	ATCACTGCCACAAGGTCGTTGAGCTGGT CACAAGGTTGTGGAATTGGTTGCAGAAT GGTCATGGCCACAAGGTCTGCGAGCTAG TAAGGTTGTTGAATTGGTGGCTGAAATG TAGCGGTATAACTCTGGGAGTGCTCGTG TCGTTGAATTGGTTGCTGAATTGAATGG TCTGTGAGCTAGTTGCTGAATTGGATGG	{557} {565} {556} {567} {615} {572} {572}
7.118526590941621	517	708	191	517	5	0.9939759036144579	CCCTACGTGTTCATTAAACGATCTGAAGCT CCCTATGTGTTCATTAAACGATCTGAAGCC CCCTATGTGTTCATTAAACGATCTGATGCT CCCTATGTGTTCATTAAACGTTCTGACGCC CCCTATGTGTTCATTAAACGTTCTGATGCC	678	2	0.9909638554216867	TGTTCTTCTCCGTAAGAATGGTAATAAGGG TGTTCTTCTTCGTAAGAACGGTAATAAGGG	8	0.9819277108433735	ATCACTGCCACAAGGTCGTTGAGCTGGT CACAAGGTCGTTGAATTGGTTGCTGAAT CACAAGGTTGTGGAATTGGTTGCAGAAT GCTAGTTGCTGAATTGGATGGCGTGCAG TAAGGTTGTTGAATTGGTGGCTGAAATG TAGCGGTATAACTCTGGGAGTGCTCGTG TCGTTGAATTGGTTGCTGAATTGAATGG TCGTTGAGTTGGTTGCAGAAAAGGAAGG	{557} {565} {565} {579} {567} {615} {572} {572}
7.180722592664184	9439	9658	219	9439	5	0.9909638554216867	GCCTATCTACCAGTGGTAGATGGGTTCTTA GCCTGTCTACTAGTGGTAGATGGGTTCTTA GCTTATCTACTAGCGGTAGATGGGTTCTTA GCTTGTCTACTAGCGGTAGGTGGGTTCTTA GTGTATCTACTAGTGGTAGATGGGTACTTA	9628	3	0.9909638554216867	CTGCCTACTACTTTATGAAATTCAGACGTG CTGCCTACTATTTCATGAAGTTTAGACGTG CTGCTTACTACTTTATGAAATTCAGGCGTG	2	0.9819277108433735	AGCAGGTGGTATCATTGCCATATTGGTG GGGTGGTATTATTGCCATATTGGTGACT	{9593} {9596}
7.201511090344213	459	639	180	459	4	0.9909638554216867	AAATGGCACTTGTGGCTTAGTAGAGCTGGA AAATGGCACTTGTGGTCTAGTAGAGCTGGA AAATGGCACTTGTGGTTTAGTAGAGCTGGA AAGTGGCACTTGTGGCATAGTAGAGCTGGA	609	3	0.9909638554216867	CGGTCGTAGCGGTACAACACTGGGAGTTCT CGGTCGTAGCGGTATAACACTGGGAGTACT CGGTCGTAGCGGTATAACTCTGGGAGTGCT	9	0.9819277108433735	ATCACTGCCACAAGGTCGTTGAGCTGGT CACAAGGTTGTGGAATTGGTTGCAGAAT GCTAGTTGCTGAATTGGATGGCGTGCAG TAAGGTTGTTGAATTGGTGGCTGAAATG TCGTAGAGCTGGTTGCAGAATTGGATGG TCGTTGAATTGGTTGCTGAATTGAATGG TCGTTGAGTTGGTTGCAGAAAAGGAAGG TCGTTGAGTTGGTTGCAGAATTGGACGG TCTTTGAGTTGGTTGCTGAATTGGATGG	{557} {565} {579} {567} {572} {572} {572} {572} {572}
8.005335466635868	9496	9740	244	9496	5	0.9909638554216867	GAGTATTCTGTGGTGTTGATGCAATGAATC GAGTCTTTTGTGGTGTTGATGCCATGAATC GAGTTTTCTGTGGAGTCGATGCTATGAATC GAGTTTTCTGTGGTGTCGATGCTATGAACC GAGTTTTCTGTGGTGTTGATGCGATGAATC	9710	4	0.9909638554216867	GTCATTCACTGTACTCTGTTTAACACCAGT GTCTTTCACTATACTCTGTCTGGCACCAGC GTCTTTCACTATACTCTGTCTGGCACCTGC GTCTTTCACTATACTCTGTCTGGTACCAGC	3	0.9879518072289156	AGCAGGTGGTATCATTGCCATATTGGTG GCTTTAGATGTGTCTGCTTCAGTAGTGG GGGTGGTATTATTGCCATATTGGTGACT	{9593} {9567} {9596}
