cost	target-start	target-end	target-length	left-primer-start	left-primer-num-primers	left-primer-frac-bound	left-primer-target-sequences	right-primer-start	right-primer-num-primers	right-primer-frac-bound	right-primer-target-sequences	num-guides	total-frac-bound-by-guides	guide-target-sequences	guide-target-sequence-positions
2.757011090344213	759	849	90	759	1	0.9974160206718347	ACAACCCCTGAGGTGACAGGTTCTGGTGGT	819	1	0.9948320413436692	ACAACATGGCTTCAAGCCTAAAACAGGGAG	3	0.9948320413436692	GTTTAGTGAGCAAACATACAATAGCCAG TTAGTAAGCAGACATACAATAGACAGTG TTAGTGAGCAGACATACAATAGACAGTG	{789} {791} {791}
2.7726515990016813	690	813	123	690	1	0.9948320413436692	TTGAGCCTAGCGTTGGGCTACGTTCTCGCA	783	1	0.9922480620155039	GGTGGTGTTTAGTGAGCAGACATACAATAG	1	0.9922480620155039	GACGTTTGTAGGGGGTAGTGCCAAACAA	{735}
2.8975010878282044	690	843	153	690	1	0.9948320413436692	TTGAGCCTAGCGTTGGGCTACGTTCTCGCA	813	1	0.9948320413436692	ACAGTGACAACATGGCTTCAAGCCTAAAAC	1	0.9922480620155039	ACGACGTTTGTAGGGGGTAGTGCCAAAC	{733}
3.738132422683972	587	807	220	587	2	0.9974160206718347	TCTAGCGGTACGCGGGTGTGTGGAAGTAGC TCTAGCGGTAGGCGGGTGTGTGGAAGTAGC	777	1	0.9922480620155039	GGTTCTGGTGGTGTTTAGTGAGCAGACATA	1	0.9974160206718347	TCTAAGGGCTTTTGAGCCTAGCGTTGGG	{679}
3.7594468288076466	13116	13347	231	13116	1	0.9948320413436692	GGTAGCAGTGAGGCTCGGCTGATACCCCTT	13317	2	0.9922480620155039	AAACAAACCACTCCTAGTAATTATGAACAT AAACAGACGACTCCCTCTAATTACGCCCAT	1	0.9896640826873385	CCTGATGTTGTAAAGCGAGCCTTTGATG	{13161}
3.7932219161711367	587	837	250	587	2	0.9974160206718347	TCTAGCGGTACGCGGGTGTGTGGAAGTAGC TCTAGCGGTAGGCGGGTGTGTGGAAGTAGC	807	1	0.9948320413436692	CAATAGACAGTGACAACATGGCTTCAAGCC	1	0.9974160206718347	TCTAAGGGCTTTTGAGCCTAGCGTTGGG	{679}
4.266737705370951	587	751	164	587	2	0.9974160206718347	TCTAGCGGTACGCGGGTGTGTGGAAGTAGC TCTAGCGGTAGGCGGGTGTGTGGAAGTAGC	721	2	0.9922480620155039	AAGGTCGGCTATACGACGGTTGTAGGGGGT AAGGTCGGCTATACGACGTTTGTAGGGGGT	1	0.9974160206718347	TCTAAGGGCTTTTGAGCCTAGCGTTGGG	{679}
4.384143513028185	11441	11651	210	11441	1	0.9922480620155039	CAACTGTTGTTTTAATGCAGCTTTTGACTA	11621	3	0.9922480620155039	GTGAATATTGTGATGATATACTTAAGAGAT GTGAGTATTGTGATGACATACTTAAGAGAT GTGAGTATTGTGATGATATACTTAAGAGGT	1	0.9948320413436692	GAAGCAAATTCAAAAATGCATGCTTATC	{11482}
4.441885737400775	26924	27111	187	26924	2	0.9948320413436692	ACAATGTAATTTTGCTATAGAGAGTGTGCC GCAATGTAACTTTGCTATAGAGAGTGTGCC	27081	2	0.9948320413436692	CGTATGGTGCAGAAATACACTGGTGACCAA CGTATGGTGCAGAAATATACTGGTGACCAA	2	0.9922480620155039	CTCCTATTATTAAGAATGGTATTCTTTA GCTTGCTAAATGTGAACCAGACCACTTG	{26965} {27008}
4.5139225926641835	13319	13538	219	13319	2	0.9922480620155039	ACAAACCACTCCTACTAATTATGAACATGA ACAAACCACTCCTAGTAATTATGAACATGA	13508	2	0.9922480620155039	AGTTCTTAAAGAAATACTTGTCACTTATGG AGTTCTTAAGGAAATACTTGTCACTTATGG	2	0.9974160206718347	TACGAAGACTTAAAGTCAGAAGTAACAG TATAATATTAGTAGGCAACGGCTTACTA	{13359} {13422}
