cost	target-start	target-end	target-length	left-primer-start	left-primer-num-primers	left-primer-frac-bound	left-primer-target-sequences	right-primer-start	right-primer-num-primers	right-primer-frac-bound	right-primer-target-sequences	num-guides	total-frac-bound-by-guides	guide-target-sequences	guide-target-sequence-positions
2.923954591467449	18793	18954	161	18793	1	1.0	TTGGAATTGCAATGTGGATTGTTATCCACA	18924	1	1.0	CTGATGCATTTAATAAAAATGCTTTTGTTA	1	1.0	CTGTAGATTTGACACACGTGTGTTGTCA	{18835}
2.93097901698314	15175	15308	133	15175	1	1.0	TGGTAATAAGATTTACACTACTTATGTGCA	15278	1	1.0	TATAACTATTTGCGTAAGCATTTTAGTATG	2	1.0	TACTTGGGTATATACCGTAGTAATACTG TATACTTAGGTATATACCGTAGTAATAC	{15224} {15222}
2.9333377053709504	18925	19037	112	18925	1	1.0	TGATGCATTTAATAAAAATGCTTTTGTTAA	19007	1	1.0	ACTGGTGTGTCTACTAATTATGTCAGTGAA	3	1.0	ACCACTCCCATTTTTCTACTATTCGGAT TACTATTCAGATACAGCATGTGAGAATG TTTCTATTATTCCGACACAGCATGTGAA	{18961} {18977} {18973}
3.1162354666358683	18793	19037	244	18793	1	1.0	TTGGAATTGCAATGTGGATTGTTATCCACA	19007	1	1.0	ACTGGTGTGTCTACTAATTATGTCAGTGAA	1	1.0	CTGTAGATTTGACACACGTGTGTTGTCA	{18835}
3.3798405378427523	15220	15317	97	15220	2	1.0	GTTATACTTGGGTATATACCGTAGTAATAC GTTATATTTGGGTATATATCGCAGTAATAC	15287	1	1.0	TTGCGTAAGCATTTTAGTATGATGATCCTT	2	1.0	TGAGTTAGTTTTAGATTATTATAACTAC TGTAGATAATGAGTTAGTGTTGGACTAT	{15259} {15250}
3.4128433771173463	13078	13167	89	13078	1	1.0	TACTAGTGGAGTAGCCCGTCTAGTACCCCT	13137	2	1.0	TAAGGGCTTTTGACATTTGTAACACAAAAG TAAGGGCTTTTGATATATGTAACACAAAGG	3	1.0	AGGCTCTGGTGTACAACCAGATATAGTA AGGTTCTGGTGTACAACCAGATATAGTA AGGTTCTGGTGTAGAACCAGATATTGTA	{13108} {13108} {13108}
3.4128433771173463	15116	15205	89	15116	2	1.0	AGTGTTTTTAACATCTGTCAAGCAGTTAGT AGTGTTTTTAATATTTGTCAGGCTGTTAGT	15175	1	1.0	TGGTAATAAGATTTACACTACTTATGTGCA	3	1.0	CTAACCTTAATACATTCCTTTCTGTGGA GCTAACCTTAATACCTTTTTATCTATAG GCTAATCTTAATACTTTTCTATCTATAG	{15147} {15146} {15146}
3.5604701280549222	13090	13215	125	13090	1	1.0	AGCCCGTCTAGTACCCCTAGGTTCTGGTGT	13185	2	1.0	ATTTAAAGAATAATTGTTGTAGGTATCAAG ATTTGAAAAACAATTGCTGTAGGTATCAAG	2	1.0	TGTAACACAAAAGTAGCAGGATTTGGCC TTTGTAACACAAAAGTTGCAGGTTTTGG	{13154} {13152}
3.5777006335339796	29472	29629	157	29472	2	1.0	GGTATAAGTAAGCTGTGCATTCGCTATGTT GGTATAAGTAAGTTGTGCATTCGCTATGGT	29599	1	1.0	ATTTTAAGCAACCCCTAATCATAGTATGCT	1	1.0	TAGGTTTAGAATGTAGTTTAGTGCTAGC	{29502}
3.5976790169831396	26652	26785	133	26652	1	1.0	TTTGAACGAACCTATTATGTCTGGACGGAA	26755	2	1.0	GAACGCCGTAATGGTAACCGTAATGGTGCC GAACGCCGTAATGGTAACCGTTCTGGTGCC	2	1.0	ACAAGAATCTGACGGTTCTGACTCCGAA TCAAACAAGAATCTGATAATTCTGACTC	{26724} {26720}
