cost	target-start	target-end	target-length	left-primer-start	left-primer-num-primers	left-primer-frac-bound	left-primer-target-sequences	right-primer-start	right-primer-num-primers	right-primer-frac-bound	right-primer-target-sequences	num-guides	total-frac-bound-by-guides	guide-target-sequences	guide-target-sequence-positions
2.5126942636811997	30888	30976	88	30888	1	0.9909638554216867	ATTCCATGAGTGGAGCTTCTGCTGATTCAA	30946	1	0.9939759036144579	ACAAGGCAGATGGGCTATGTAAACGTTTTC	1	0.9909638554216867	CTCAGGCATAAACACTCATGATGACCAC	{30918}
2.534811090344213	30665	30755	90	30665	1	0.9909638554216867	GGAGCCATTAAATTGGATGACAAAGATCCA	30725	1	0.9939759036144579	AAGCACATTGACGCATACAAAACATTCCCA	1	0.9909638554216867	CAATTCAAAGACAACGTCATACTGCTGA	{30695}
2.565364373321448	30623	30716	93	30623	1	0.9939759036144579	GGCATGGAAGTCACACCTTCGGGAACATGG	30686	1	0.9909638554216867	AAAGATCCACAATTCAAAGACAACGTCATA	1	0.9909638554216867	CTGACTTATCATGGAGCCATTAAATTGG	{30653}
2.7172439250039426	30897	31010	113	30897	1	0.9909638554216867	GTGGAGCTTCTGCTGATTCAACTCAGGCAT	30980	1	0.9939759036144579	TTCCGTTTACGATACATAGTCTACTCTTGT	1	0.9849397590361446	AAACACTCATGATGACCACACAAGGTAG	{30927}
2.801814134296109	27469	27598	129	27469	1	0.9909638554216867	ATTACAAATTAGGAGCGTCGCAGCGTGTAG	27568	1	0.9909638554216867	CCGGTAGCAACGACAATATTGCTTTGCTAG	1	0.9849397590361446	GCACTGATTCAGGTTTTGCTGCATACAA	{27499}
2.8452000822449524	30577	30716	139	30577	1	0.9939759036144579	ACAATTTGCTCCAAGTGCCTCTGCATTCTT	30686	1	0.9909638554216867	AAAGATCCACAATTCAAAGACAACGTCATA	1	0.9939759036144579	CTTCGGGAACATGGCTGACTTATCATGG	{30639}
2.862723285568201	29703	29822	119	29703	1	0.9939759036144579	GCATTACATTTGGTGGACCCACAGATTCAA	29792	1	0.9909638554216867	GGTTTACCCAATAATACTGCGTCTTGGTTC	2	0.9879518072289156	GACGCAATGGGGCAAGGCCAAAACAGCG TAACCAGGATGGAGGACGCAGTGGTGTA	{29754} {29740}
2.9333377053709504	30743	30907	164	30743	1	0.9939759036144579	AAAACATTCCCACCAACAGAGCCTAAAAAG	30877	1	0.9909638554216867	ACAACTTCAAAATTCCATGAGTGGAGCTTC	1	0.9849397590361446	CACTGTGACTCTTCTTCCTGCGGCTGAC	{30832}
2.9563000822449523	29818	29957	139	29818	1	0.9909638554216867	GTTCACAGCTCTCACTCAGCATGGCAAGGA	29927	1	0.9939759036144579	AGAGCTACCCGACGAGTTCGTGGTGGTGAC	2	0.9909638554216867	GAACTTAGATTCCCTCGAGGCCAGGGCG GGACTCAAATTCCCTCAAGGCCAGGGAG	{29849} {29849}
2.973823285568201	30577	30755	178	30577	1	0.9939759036144579	ACAATTTGCTCCAAGTGCCTCTGCATTCTT	30725	1	0.9939759036144579	AAGCACATTGACGCATACAAAACATTCCCA	1	0.9939759036144579	CTTCGGGAACATGGCTGACTTATCATGG	{30639}
